abandon - 放纵；放弃
abase - 降低(地位、职位、威望或尊严)
abash - 使尴尬，使羞愧
abate - 减轻(程度或者强度)；减少(数量)，降低(价值)
abbreviate - 缩写，缩短
abdicate - 正式放弃(权力、责任)
aberrant - 异常的，非常规的
abet - 鼓励
abeyance - 中止，搁置
abhor - 深恶痛绝，极度厌恶
abiding - 持久的
abject - (地位、身份)悲惨、凄凉的；卑微的，讨好的
abjure - 发誓放弃；抵制，避免
abnegate - 否认
abominate - 痛恨，厌恶
aboveboard - 无欺诈的，光明正大的
abrade - 磨损，精神上折磨
abridge - 缩短，缩小
abrogate - 官方的正式废除
abscond - 偷偷离开
absolute - 专制的；无限的；完美的，纯净不掺杂的；不容置疑的，确凿的
absolve - 使无罪，解除责任
abstain - 自我克制，主动戒绝
abstemious - (吃喝等)有节制的，节俭的
abstract - 做总结，概括；使分心
abstruse - 难以理解的
absurd - 不合理的
abundant - 大量的
abuse - 辱骂，抨击；不正当或不合理使用
acquainted - 熟悉的
abysmal - (程度)很深的；极端的
accede - 赞成
ad hoc - 专门的
accessible - 可以到达的；可理解的
accessory - 辅助的，附属的
accidental - 意外发生的，偶然的
acclimate - 使适应
accolade - 同意，赞赏；赞扬
accommodate - 改变以适应新情况、新场景；使和谐
accentuate - 强调
accrete - 逐渐增长
accumulate - 逐渐增长
acerbic - (心情、心境或者语调)尖酸的
acme - 顶点，极点
acquiesce - 勉强同意；默许
acrid - 刻薄的
acrimonious - 刻薄的，充满仇恨的
acumen - 不同寻常的洞察力和鉴别力
acute - 敏锐的；(程度、影响)极强的
adamant - 固执的，不可动摇的
adapt - 修改，使(适应)
