cloak - 遮掩，隐藏
convention - 常规，习俗；大会，集会
converge - 汇集，交汇于一点
conversant - 熟悉的
convert - 改变，转化
consort - 结交
cagey - 不乐意说话的
conviction - 深信，确信；证明有罪
convoke - 召集开会
convoluted - 复杂的，费解的
convulsion - 骚乱
coop - 监禁，困于…之中
copious - 丰富的，大量的
coquette - 调情，不认真对待
countervail - 抗衡，抵消
cornucopia - 大量
coronation - 加冕，加冕礼
corporeal - 肉体的；有形的，实体的
corroborate - 用证据或权威证实；为…提供证据，支持
corrosive - 腐蚀性的；讽刺性的
corrugated - 褶皱的
cosmopolitan - 有世界性眼光的，包容的
cosset - 宠爱
countenance - 容忍；赞成，推崇
counterfeit - 仿制的，假冒的；仿制
countermand - 取消，撤销
court - 追求，献殷勤
covert - 隐蔽的，秘密的
covetous - 贪婪的，渴求财富的
cow - 恐吓，威胁
cowardice - 懦弱，不坚定
cower - 畏缩
cozen - 诱骗
cramped - 狭小的，狭窄的
crass - 粗俗的，愚钝的
crave - 热望
craven - 非常懦弱的，因胆小而遭人鄙视的
contingency - 可能发生的事
credence - 坚信
credulous - 轻信的，易受骗的
caterwaul - 嚎叫
creep - 缓慢地行进
crescendo - (渐强之后到达的)顶峰
crest - 顶部，浪尖，山顶
crestfallen - 垂头丧气的，沮丧的
cronyism - 任人唯亲，对好友的偏袒
crook - 使弯曲
croon - 低声歌唱或说话
culminate - 达到高潮
crucial - 非常重要的，决定性的
crumple - 弄皱
