crutch - 支撑，支柱
crux - 中心，关键点
cryptic - 秘密的；难以理解的
culpable - 该受谴责的，有罪的
cultivate - 提升，加强；种植，培养
cumbersome - 笨重的，难处理的
cunning - 狡猾的
curmudgeon - 脾气坏的、爱抱怨的人
cursory - 匆忙的，不注意细节的
curt - 言辞简略的，直接(以致显得粗鲁)的
curtail - 缩短，削减
cynic - 反人类的喷子
dabble - 涉猎，对…浅尝辄止
daft - 不明智的
dazzling - 炫目的，耀眼的
dally - 虚度时光
damper - 抑制因素
dandy - 纨绔子弟，爱打扮的人
dank - 阴湿的
dapper - 衣冠整洁的
dappled - 有斑点的，花的
daredevil - 大胆鲁莽的(人)
dart - 突然移动，猛冲，狂奔；公开侮辱
daunt - 使胆怯，吓倒
dawdle - 拖拖拉拉
deadpan - 无趣的，无生气的，不活泼的
dearth - 供应不足
debacle - 溃败
debark - (使)下船(飞机，车等)；卸(客，货)
debase - 贬低，贬损
debilitate - 使衰弱
debris - 废墟
debunk - 揭露…的真面目
debut - 初次登台，出道
decadence - 衰落，颓废
detest - 厌恶
decipher - 破译；对…有清晰的想法，理解，解读
decode - 解码；对…有清晰的想法，理解，解读
decorous - 得体端正的
decrepit - 虚弱的，衰老的，破旧的
default - 不履行义务，玩忽职守
defer - 推迟，延期遵从
document - 证实
deficiency - 缺乏，不足
devious - 狡猾的
deft - 灵巧的，熟练的
defuse - 抚慰，减轻
defy - 蔑视
dehydrate - 去除水分，使干燥；使失去活力
deify - 尊崇，尊敬
deject - 使沮丧
