deleterious - 有害的
deliberate - 深思熟虑的
delicacy - (外貌、结构等)精致
delirium - 精神错乱；极度兴奋，发狂
delusion - 错觉，妄想
deluge - 大暴雨；大量
delve - 探究，钻探
demagogue - 蛊惑民心的政客
demanding - 难取悦的，难满足的费时间花心思的
demolition - 破坏，毁坏
demonstrate - (通过证据)证明，表明
demoralize - 使士气低落贬低，使堕落
demotic - 通俗的，大众化的
demur - 表示异议，反对
denigrate - 诋毁，污蔑
disingenuous - 不真诚的，假惺惺的
denounce - 公开指责
dent - (数量、程度上)削弱
denude - 脱去，使赤裸
deplete - 耗尽，使衰竭
deplore - 谴责，强烈反对
deploy - (有目的地)展开；调度，部署
deportation - 放逐
depose - 宣誓作证；废黜，罢免
deposit - 自然积累，沉积，矿藏；存钱
depravity - 道德败坏
deprecate - 不喜欢；贬低，轻视
depreciate - 贬低…的价值
depressed - 不开心的，情绪不高的，消沉的
deprivation - 匮乏
deracinate - 根除
derelict - 玩忽职守的，不认真的
deride - 嘲弄，嘲笑
derivative - 非原创的
descend - 下降；世代相传
divination - 预言
desecrate - 亵渎，玷污
desiccate - 使缺乏活力
designate - 任命；命名
despicable - 令人鄙视的
despise - 极其不喜欢
despotic - 专制的，暴虐的
desultory - 无计划的，无目的的
detach - 使分离
detain - 拘留，扣留
deter - 吓住，威慑
deterioration - 恶化；堕落
detour - 偏离正常标准
detract - 贬低，降低价值；使分心
detritus - 废品，碎屑，遗骸
devoted - 投入的；忠诚的
