devout - 忠诚的
dexterous - 动作灵活的；头脑灵活的
diabolic - 恶魔一般的
diaphanous - 模糊的；非实在的；(质地精致得)几乎透明的
diatribe - 长篇抨击性演讲
didactic - 喜欢说教的，思修的
diehard - 顽固的，保守的顽固的人，保守的人
dovish - 鸽派的，爱好和平的
diffuse - 啰嗦的；扩展，散开
digress - 脱离主题
dilapidate - (使)荒废
dilate - (使)膨胀，扩大
dilatory - 拖延的，磨蹭的
dilettante - 业余爱好者(对艺术或知识领域涉猎浅薄者)缺乏专业技术的
diligent - 勤勉的，辛勤的
dilute - 稀释；经稀释的
diminish - (使)变小，(使)减少；轻视，贬低
disquisition - 专题论文
dingy - 昏暗的；肮脏的
diocesan - 主教管辖区的
diplomatic - 使用策略的，机智的
dire - 可怕的，恐怖的；迫切的
demography - 人口统计学
disabuse - 打消错误念头，纠正
disaffected - 不满的，叛逆的
disarm - 使息怒，平息，抚慰
disarray - 混乱，无秩序；使混乱
disavow - 拒绝承认，否认
discern - 识别，辨别差异
discharge - 解雇；释放
disciple - 信徒，追随者
discombobulate - 使不安，使混乱
discomfit - 使尴尬；阻碍
discommode - 打扰，使不便
discompose - 使不安；使混乱
disconcert - 使不安
discord - 意见不一致，不和谐
discredit - 羞辱，使丧失名誉；怀疑，不相信
discrepancy - (在事实和宣称之间的)差异或矛盾
discrete - 离散的，不连续的
discretion - 谨慎；自制，节制
discretionary - 自主决定的
discriminate - 区分；歧视
discursive - (谈话内容)杂乱的
disdain - 轻视，鄙视
disengage - 分开，使脱离
disgorge - 呕吐出
disgruntle - 使发怒，使不满意
dignified - 高贵庄严的
disinclination - 不喜欢，厌恶，不情愿
disinfect - 消毒，使无菌
