disjointed - 不连贯的
disinter - (从墓地里)掘出
disinterested - 公正的，无偏见的
disjunctive - 分离的
dismantle - 分解，分拆
dismay - 使失去勇气；使不安，使焦虑
disparage - 贬低，轻蔑地说
disparate - 迥然不同的
dispassionate - 客观公正的，不易被情绪或偏见影响的
dispatch - 迅速；发送，派遣
dispose - 使倾向于；处理掉(与of连用，disposeof)
disregard - 漠视，不关注；缺乏兴趣，缺乏关心
dissect - 仔细分析
dissemble - 用假象隐藏真相，掩饰
disseminate - 散播，传播
dissension - 意见不合
dissent - 持异议，不同意；反对正统
dissipate - 驱散；浪费
dissolute - 放荡的，无节制的
dissolve - 溶解，融化；解散
dissonance - (音调)不和谐，刺身；不一致，分歧
dissuade - 劝阻，反对
distain - 贬损，伤害(某人的)名誉
distal - 远离中心的，(神经)末梢的
distend - (使)膨胀
distill - 对…用蒸馏法提高纯度
distort - 扭曲，歪曲
distract - 转移(注意力)，使分心
distraught - 精神狂乱的，极疯狂的
diurnal - 白天发生或行动的
diverge - (使)分叉，散开；分歧
diversity - 多样性
divert - 使转向；使消遣
divestiture - 剥夺
divulge - 泄露(秘密)
dodder - 蹒跚，颤巍巍地行进
dodge - 躲避
doff - 脱下
dogged - 固执的，任性的
dogmatic - 武断的，自以为是的
doldrums - 低迷，中断
dolorous - 忧伤的
dolt - 笨蛋
domicile - 为…提供住处
dominant - 处于支配地位的；(基因)显性的
don - 穿上
donor - 捐赠人，给体
doodle - vi(无目的地)乱涂乱画；漫无目的地打发时光
dormant - 静止的，不活跃的
dour - 严厉的
douse - 熄灭
