downplay - 轻描淡写，不予重视
doom - 注定(倒霉)
doyen - 有经验的人，资深人士，老司机
doze - 小憩
draconian - 极其严酷的；十分严厉的
drawl - 慢吞吞地说
dreary - 单调乏味的
drench - 使湿透，浸透
drivel - 胡言乱语
diminutive - 极小的
drollness - 搞笑，逗逼
drone - 低沉单调地说；嗡嗡地叫
drudgery - 苦工；单调、卑贱或无趣的工作
dubious - 充满不定性的，值得怀疑的
ductile - 易受影响的
dulcet - 悦耳的，令人愉悦的
dullard - 笨蛋
dupe - 易受骗的人；欺骗
duplicitous - 两面派的，奸诈的
dwindle - 逐渐减少
dyspeptic - 脾气坏的
earnest - 严肃认真的
embryonic - 初期的，萌芽阶段的
earsplitting - 震耳欲聋的
eavesdrop - 偷听
ebullient - 热情奔放的
eccentric - 行为出格的，不循规蹈矩的
éclat - 辉煌成就
eclipse - 使声望下降，使黯然失色
ecstasy - 狂喜
ecumenical - 世界范围的，普遍性的
edible - 可食用的
edifice - 大厦，大建筑物；基础，基本框架
efface - 擦掉，抹去；使不明显
effervesce - 兴奋，热情洋溢
effete - 衰弱的，衰落的
effluvium - 难闻的气味
effrontery - 厚颜无耻，放肆大胆
effulgent - 光辉灿烂的
effusive - 感情泛滥的溢于言表的；感情表达不节制的过度的；过分多情的
egalitarian - 平等主义的
egoistic - 利己的，以自我为中心的
elaborate - 详细的，复杂的；详细阐述
elastic - 有弹性的；能(迅速从伤痛中)恢复的
elate - 使开心，使自豪
eleemosynary - 慈善的
elegy - 哀歌(诗)，挽歌(诗)
elephantine - 巨大的；笨拙的
elevate - (在道德、智力、文化水平上)提升；使兴奋
elicit - 激起，唤起
elliptical - 含糊不清的；椭圆的
