elucidate - 阐明
emaciate - 削弱
emancipate - 解放，解除束缚
embargo - 贸易禁止令
embark - 开始从事
embarrass - 使尴尬
embed - 嵌入
embezzle - 盗用
embolden - 鼓励，使大胆
emboss - 装饰
embrace - 乐于接受
embroider - (时常伴有夸张和想象内容地)详细说明
emigrate - vi移民，移居海外
eminent - 杰出的
emollient - 起缓和作用的
emulate - 效仿
enact - 制定或颁布(法律)
enamel - 装饰
encomium - 赞颂之词
encompass - 组成，包含
encumber - 阻碍；妨碍
endemic - 地方性的
endorse - 公开支持
enervate - 使衰弱
enfranchise - 给予…权利(例如选举权)；解放
engender - 引起，使发展
engross - 使全神贯注
enigma - 难以理解或解释的事物，谜
enlighten - 使知道，启发
enmity - 敌意
ennoble - 使尊贵
ennui - 倦怠；缺乏兴趣
expostulate - 争论，辩驳
ensconce - 隐藏
ensue - 紧随其后
entangle - 使变复杂或困难
episodic - 片段的，断断续续的
entice - 诱使
entrance - 使入迷
entrap - 诱骗
entreat - 恳求
enunciate - 清晰地说；公开宣布，宣称
ephemeral - 短暂的
epic - 宏大的，超凡脱俗的
epicure - 美食家
epigram - 机智的短诗，警句
epilogue - 文学作品的结局
epithet - 外号，绰号
epitomize - 代表，体现，是…的典型范例
equable - (脾气、性情)温和的
equity - 不偏不倚，公平
