equivalent - 等价的，相等的
equivocate - (带有欺骗目的地)模棱两可地说，说谎话
empirical - 基于观察、实验的
errant - 误入歧途的，犯错误的
erratic - 善变的
erudite - 博学的
escalate - (使)(战争等)升级，扩大
eschew - 刻意避开；戒绝
esoteric - 深奥难懂的
espouse - 支持；拥护
esteem - 尊重
estimable - 值得尊敬的
estrange - 使疏远，离间，使感情失和
etch - 留下深刻印象，铭记
eternal - 永恒的
ethereal - 轻巧精致的；非物质的，精神(上)的
ethics - 道德规范
eulogize - 称赞；颂扬
euphemism - 婉言，委婉的说法
euphonious - 悦耳的
euphoria - 感觉极其愉快
evacuate - 撤离
evanescent - 逐渐消失的，短暂的
entail - 牵连；导致
everlasting - 永恒的，持久的
evict - 赶出，逐出
evince - 表明
evoke - 唤起，引发
exacerbate - 使加剧，使恶化
exacting - 严格的，苛求的；费时间花心思的
exalt - 赞扬
exasperate - 激怒
excavate - 挖掘，挖空
exceptional - 例外的，特别的，非凡的
excoriate - 严厉批评
excrete - 排泄
excruciate - 折磨，使痛苦
exculpate - 声明无罪；开脱，使无罪
excursive - 离题的；散漫的
execrate - 痛恨
exemplary - 榜样的，值得效仿的
exempt - 使免除
exhaust - 耗尽
exhilarate - 使高兴；使兴奋
exhort - 敦促，力劝
exigent - 紧急的
exodus - 大批离去
exonerate - 免除责备
exorbitant - 过度的
exotic - 外来的，不同寻常的
expansive - 话多的，健谈的
