expedite - 加快进程
expediency - 应急手段，权宜之计
expiate - 赎罪，纠正
expire - 断气，死亡；到期
explicit - 表达清晰的；成熟的，完全形成的
exploit - 英雄行为；最大程度地利用
exponent - 倡导者，支持者
expurgate - 净化(书等)，删去(不当处)
exquisite - 精致精巧的
extant - 现存的
extemporize - 即兴表现
extenuate - 减轻罪过
extinct - 灭绝的
extinguish - 熄灭
extol - 赞美；吹捧
extort - 勒索
extract - 用力拔出
encyclopedic - 全面的，百科全书式的
extraneous - 无关的，不重要的
extravagant - 挥霍的；过度的，不必要的
extricate - 使解脱，救出
exuberant - 非常高兴的，热情洋溢的
exude - 分泌，流出
exult - 感到欢喜
fable - 神话，传说；谎言，虚构
fabricate - 捏造
facetious - 喜欢开玩笑的，轻浮的
facile - 表面的，浅尝辄止的
facilitate - 使变容易，促进
faction - 派系
fallacious - 谬误的，不合逻辑的
fallow - 休耕的
fail-safe - 保险措施；万无一失的
falsehood - 谎言
falter - 蹒跚；犹豫，踌躇
fanatic - 狂热者；狂热的；盲信的
fantasy - 幻想；产生幻想
farce - 闹剧
fascinate - 强烈吸引，使入迷
fast - 绝食；斋戒；忠诚的
fastidious - 挑剔的，极仔细的，追求完美的
fateful - 意义重大的
fathom - 彻底理解，弄懂
fatigue - 疲惫
fatuous - 愚笨的，昏庸的
faultfinder - 吹毛求疵的人
favorable - 有利的
fawn - 阿谀奉承
faze - 打扰，使尴尬
feckless - 无成果的，没有价值的；粗心不负责任的
fecund - 多产的，肥沃的
