feeble - 衰弱的
feign - 制造假象，装出…的样子
foreshadow - 预示
feral - 野生的
fertilize - 使肥沃，使多产
fervid - 酷热的；热情的
forte - 优势，长处
fester - 感染，溃烂，腐烂
fetid - 恶臭的
fetter - 束缚
fiasco - 大失败
fickle - 易变的
fictitious - 虚构的
fidelity - 忠诚
figurative - 比喻的
fractious - 难以管束的
filibuster - 拖延议事
filter - 过滤
finale - 终场，结局
finesse - 娴熟技巧；(巧妙地)躲避
finicky - 过分讲究的，挑剔的
flaccid - 不结实的，松弛的
flag - 变得衰弱
flamboyant - 艳丽夺目的，炫耀的，充满装饰的
flatter - 拍马屁，奉承，讨好
flaw - 瑕疵，缺点；降低，破坏，使不完美
fledgling - 新手
fleet - 迅速的
flexible - 灵活的，可变的；易受影响的
flinch - 畏缩；退缩
flippancy - 轻率，无礼
flirt - 调情
flit - 快速或突然地经过
flock - 聚集，集体行动
florid - 辞藻华丽的，花哨的
flounder - 笨拙地行动，挣扎
flourish - 茂盛；繁荣
flout - 嘲弄性不理会，蔑视
flabby - 疲软的，无力的
fluent - 表达流利的
fluky - 侥幸的
flush - 大量的；冲洗
fluster - 使慌乱
foible - 小缺点
foil - 挫败
foment - 助长，煽动
foolproof - 十分简单以至于不会失败的
footloose - 无拘无束的，自由的
forbearance - 克制；忍耐
forebear - 祖先
forestall - 预先阻止
