addict - 沉溺，上瘾；对某事上瘾的人
adhere - 服从，遵守
adjourn - 延期，休会
adjunct - 附属物，非必须部分
ad-lib - 即兴的
admonish - 建议；责备
adore - 喜爱，因…感到愉悦；宠爱
adulate - 极度谄媚，拍马屁
adulterate - 掺杂，加入低等成分
adumbrate - 预示着
adventitious - 外来的，后天的，非内在的
adversary - 敌手，对手
advert - 引起注意；提到
advocate - 支持，提倡
affable - 和蔼的，温和的
affinity - 喜欢，倾向；相似
affluent - 富裕的
aggrandize - 增加、提高(力量、财富、地位、声誉)等
aggravate - 加重，恶化
aggregate - 集合体；集合，聚集
aggressive - 好斗的；强有力的，强烈的
aggrieve - 使苦恼，使悲痛
agitate - 煽动，激起；使不安
agog - 极度感兴趣的
agonize - 折磨，使痛苦
airtight - 无瑕疵的
alacrity - 反应迅速，乐意，欣然
alibi - 不在场的证明；托辞，借口
alienate - 使…疏远
align - 调准，校准
allay - 减轻
allegiance - 忠诚
alleviate - 缓和，减轻
allude - 间接提到
allure - 吸引
ally - 盟友，支持者；加入联盟
aloft - 在空中
aloof - 高冷的
altruism - 利他主义，无私
amalgamate - 合并，混合
ambiguous - 不确定的
amble - 漫步，闲逛
ambrosial - (食物)特别美味的；香的
ameliorate - 改善，改进
amenable - 顺从的，服从的
amenity - (环境、设备等的)舒适，人性化；融洽，和谐
amiable - 好脾气的，友好易相处的
amicable - 友善的
amity - 友好关系，亲善和睦
amorphous - 无固定形状的
anodyne - 无害的
