foreword - 前言
forge - 伪造；锻造，铸就
formidable - 艰难的
forthright - 直率的，说话率真的；直接的，不绕弯子的
fortify - 加固，鼓励
foster - 促进，鼓励，培养
founder - 建立者；完败
fracas - 争吵，吵闹
fracture - 破裂；打碎，破坏
fragile - 易碎的
frail - 虚弱的；(意志)薄弱的
fraudulent - 欺诈的
fraught - 充满的
frenzy - 疯狂，狂怒
far-fetched - 牵强的，不可信的
fretful - 易怒的，烦躁的
friable - 易碎的
friction - 摩擦；冲突，不和
frigid - 严寒的；冷漠的
fringe - 边缘
frivolous - 轻浮的；不重要的
frothy - (内容等)欢乐轻佻、不严肃的
frowsy - 邋遢的
frugal - 节约的
fungible - 可互换的
full-bodied - 重要的
fulminate - 大声斥责
fumble - 笨拙地做
furor - 喧闹，狂怒；激动，狂热
furtive - 鬼鬼祟祟的；秘密的
fury - 暴怒
fussy - 谨慎的；挑剔的
fusty - 过时的；腐臭的
futile - 无效的，无用的
gadfly - 刺激物
gaffe - (社交上)失礼，失态
gainsay - 否认
gall - (使)焦躁，激怒
gallant - 英勇的
galvanize - (好似用电击)刺激
gamble - 赌博，孤注一掷
gambol - 欢跳，雀跃
gag - 笑话；玩笑之举
garble - 曲解，篡改，混淆(以至使无法理解)
gargantuan - 巨大的
garish - 过于鲜艳的，过于张扬的
generic - 无差别的，普遍的
garrulous - 啰嗦的，话多得令人厌烦的
guardian - 保护者，捍卫者
gleam - 闪光
gauche - 笨拙的，缺乏社交经验的
