gaudy - 俗丽的
gauge - 测量标准；判定
gear - 调整(以配合)
genial - 和蔼亲切的
genteel - 有教养的，不粗俗的
germane - 有关的，适当的
gibe - 嘲弄
giddy - 轻率不严肃的
gild - (带欺骗性地)修改，润色
gist - 要点
gigantic - 巨大的
glaze - 给…上釉，妆点
glib - 流利圆滑的(常含有不真诚或欺诈的成分)，油腔滑调的；缺乏深度的，肤浅的
glisten - 闪光
glitch - 小故障
gloat - 幸灾乐祸，自鸣得意
gloomy - 忧郁的
gloss - 简短解释；敷衍潦草做事(甚至忽略)
glossy - 平滑的，有光泽的
glut - 使过量，使充满
glutinous - 胶状的，粘的
glutton - 贪吃者
goad - 刺激，驱使，激发
gobble - 狼吞虎咽
goggle - 凝视
goldbrick - 逃避工作和责任
gorge - 峡谷；狼吞虎咽
gossamer - 虚无缥缈的东西；轻薄的；薄弱的
grimy - 肮脏的
gourmet - 美食家
grandeur - 宏伟，壮丽
grandiloquent - (语言等)浮夸的
grandiose - 自命不凡的，浮夸的
grandstand - 为了给人留下印象而表演，哗众取宠
grate - 刮擦(以发出刺耳的声音)；骚扰，惹恼
gratify - 使满足
gratuitous - 无根据的，无理由的；无报酬的，免费的
green - 无经验的
gregarious - 爱社交的；群居的
grieve - (使)感到悲伤
glamorous - 迷人的
grin - 咧嘴笑，咧嘴笑着表示
gripe - 抱怨
grisly - 令人反感的，令人恐惧的
groove - 享受，极其满意，过得快活
grotesque - 难看的
grovel - 卑躬屈膝
grueling - 费时间花心思的
guile - 狡猾，狡诈
glean - 收集
gull - 欺骗
