groundless - 没有依据的
gush - (使)感情强烈外溢
gust - 情感爆发
guzzle - 狂饮
hack - 雇佣文人；乱砍；开辟
hackneyed - 陈腐的，缺乏创新的
halcyon - 宁静的，平静的
hale - 强壮的，健壮的
half-baked - 不明智的
hallmark - 典型的特征
hallow - 尊敬，把…视为神圣
hallucination - 错觉
ham-handed - 笨手笨脚的
hammer - 屡次重申
hamper - 阻碍
hamstring - 使无效，使无力
hangdog - 伤心的，沮丧的
hanker - 向往，渴望
haphazard - 无秩序的，无目标的
harangue - (发表)长篇大论
harass - vt．烦扰
harbinger - 预言者
harbor - 心怀，牢记
hard-bitten - 顽强的，经受得住困境、压力的
hardy - 顽强的
harmonious - 和谐一致的
harness - 利用
harrow - 折磨，使苦恼
harry - 不断烦扰，骚扰
harsh - 严厉的
hasten - 促进
hasty - 轻率的
haunt - 常去拜访；不断地想起，萦绕心头
hauteur - 傲慢，自大
haven - 安全的地方
havoc - 大混乱
headlong - 鲁莽的，草率的
hearken - 倾听，关注
hearten - 给予鼓励，鼓舞
heartrending - 令人心碎的
hedonism - 享乐主义
hegemony - 霸权，统治权
heinous - 可憎的，十恶不赦的
hew - 遵守
herald - 预示，预兆
heresy - 异教，和普遍观点相悖的说法
heretical - 异教的，异端邪说的
hermetic - 深奥的
hagiographic - 捧为圣人一般的，过分谄媚的
heterodox - 非正统的，异端的
hidebound - 死板的，极度保守的
