hideous - 非常丑陋的
hie - 匆匆忙忙
humbug - 骗子
hilarious - 非常好笑的
histrionic - 夸张做作的
hive - 忙碌之地；储备，积累
hoard - 贮藏，秘藏
hoary - 极老的
hoax - 欺骗
hodgepodge - 大杂烩
homage - 尊敬，敬意
homely - 其貌不扬的，朴素简单的
homily - 冗长乏味的道德讲演或训诫
homogenize - 使统一化
hone - 提升，改进
hoodwink - 欺骗
hortative - 鼓励的
heartfelt - 真心实意的
hubris - 狂妄自大
humble - 谦逊的；顺从的，谦卑的
hedge - 闪烁其词
humor - 迎合，迁就
hurricane - 飓风般的事物，引起动荡的事物
husband - 节俭，勤俭持家
husk - 剥去
husky - (尤指声音)沙哑的，粗糙的
hybrid - 杂交品种，混合品种；杂交的
hymn - 赞歌，赞美诗
hyperbole - 夸张
hypnotic - 催眠的
hypocritical - 虚伪的
iconoclast - 特立独行的人
idolatrize - (通常盲目)崇拜
idyll - 无忧无虑的生活
ignite - 激起，唤起(感情等)
ignominy - 耻辱
illiteracy - 文盲
illuminati - 智者
illuminate - 阐明
illusory - 幻觉的，虚幻的
imbibe - 喝水，摄取水分
imbroglio - 困境，复杂的局面
imitation - 仿制品
immaculate - 完美的，没有任何错误的
immanent - 内在的
immaterial - 无关的，不重要的
immature - (生理、心理)未完全发展的，未发育成熟的
immemorial - 古老的
immune - 不易被感染的，有免疫力的；不受影响的
immure - 监禁，禁闭；使闭门不出
immutable - 不可变的
