impassive - 冷漠的，无感情的
impeccable - 无暇的，无可挑剔的
impecunious - 贫穷的
impede - 妨碍，阻碍
impending - 即将发生的
impenetrable - 不可渗透的，不可穿透的；难以理解的
impenitent - 不悔悟的
imperative - 命令的，强制性的；迫切的
imperial - 巨大的，令人惊叹的
imperious - 傲慢的，专横的
impertinent - 无关紧要的；粗鲁无礼的，大胆的
imperturbable - 沉着冷静的，淡定的
impervious - 不可渗透的，不可穿透的；不能被破坏的；不为所动的
impetuous - 冲动的，性急的，轻率的
impious - 不敬神的
implacable - 固执的；无法平息的
implement - 执行，实施
implode - (使)剧烈收缩，(使)坍缩，(使)内爆
importune - 恳求，迫切请求
imposing - 宏伟壮丽的
impostor - 冒充者，骗子
impotent - 无力的，无能的
imprecise - 不精确的
impromptu - 即席的表演；即席的，即兴的
improvise - 即兴而作
imprudent - 不明智的
impudent - 放肆大胆的，无礼的
impugn - 责难，抨击
impuissance - 无权，虚弱
inadvertent - 偶然发生的；疏忽的，不留意的
inalienable - 不可剥夺的，不能让与的
inane - 空洞的
inanimate - 无生命的
inaugurate - 开始
incandescent - 明亮灿烂的；热情饱满的，感情强烈的
incantation - 咒语
incarnate - 使(思想，理论)具化，体现
incendiary - 煽动者；煽动性的
incense - 激怒
inception - 开端，开始
incessant - 无间断的
inch - (使)慢慢移动
inchoate - 新生的，才开始的
incinerate - 将…烧成灰烬
incipient - 起初的，初现的
incite - 煽动，激起
inclement - (天气等)恶劣的；无情的，严酷的
incogitant - 考虑不周的，不体谅的
incongruent - 不全等的；不一致的
inconsequential - 不重要的
incontrovertible - 不可争议的
