incorrigible - 不可救药的，积习难改的；无法管制的
incriminate - 归罪于
incubate - 孵化；帮助，培养，促进
inculpate - 归罪于
incursion - 入侵
indelible - 无法忘怀的
indemnity - (损害，伤害等的)保险赔偿
indict - 起诉，控告
indifferent - 不感兴趣的，冷漠的
indigenous - 土产的，本地的；与生俱来的，先天的
indigent - 贫穷的
indispensable - 必不可少的，不可或缺的
indoctrinate - 教育，灌输思想
indolent - 懒惰的
induce - 引发，导致
indulgent - (对己)放纵的，(对他人)纵容的
indurate - 铁石心肠的，冷酷无情的；使变硬
industrious - 勤勉的
ineffable - 难以表达的
ineluctable - 无法逃避的，必然的
inept - 愚笨的，荒谬的；不称职的，无能力的
inert - (人)懒惰缺乏活力的；(物品)惰性的
inevitable - 不可避免的，必然的
inexorable - 无法劝阻的，不为所动的
infamous - 臭名昭著的
infatuate - 使迷恋
incommensurate - 不相称的
infiltrate - 秘密潜入
infinite - 无尽的，无限的
infirm - 虚弱的；不果断的，优柔寡断的
inflame - 使加剧
infelicitous - 不愉快的，不幸的；不适当的，不合时宜的
influx - 滴入
infuriate - 激怒
infuse - 灌输，使…充满
ingenious - 聪明的，有创造才能的
intermediary - 中间人
ingenuous - 天真淳朴的
ingest - 摄入，咽下
ingrained - 本质的，根深蒂固的
ingratiating - 讨人喜欢的；逢迎的，意在奉承的
inherent - 内在的，本质的
inimical - 带有敌意的
inimitable - 无法仿效的，独特的
iniquity - 邪恶，不公正
initiate - 创始，发动促进
inkling - 轻微暗示，小提示
innocuous - 无害的；不会引起敌意的
innovative - 创新性的
inquisitive - 过分好奇的
insensible - 无知觉的
