inconsistent - 不一致的，矛盾的
insentient - 无感觉的，无知觉的；一知半解的，略懂的
inconclusive - 没有定论的
insipid - 平淡的，无聊的
insolent - 粗野的，无礼的
insouciant - 无忧虑的，不在乎的
instate - 任命
instigate - 煽动，激起
instill - 灌输，使…充满
institute - 创立，制定
insubordinate - 不服从权威的
insular - (观念，想法等)孤立狭隘的
insulate - 使绝缘，使隔离，不受外界影响
insurgent - 叛乱分子
intangible - 无法感知的，无形的
integral - 完整的
integrity - 正直；完整性
intelligible - 可理解的
intemperate - 无节制的，极端的，不温和的
intensify - 加强，激化
inter - 埋葬
intercessor - 调停者
interdict - 禁止
interim - 中间过渡时期，间隔；暂时的
interlock - 连锁，连结
interminable - 无尽头的
intermittent - 断断续续的
interregnum - 过渡期
interrogate - 质问，审问
intimate - 有紧密联系的，亲密无间的；间接地沟通
intimidate - 威吓
intoxicant - 使人陶醉的东西(尤指饮料)
intransigent - 不妥协的，固执的
intrepid - 大胆的
intrigue - 阴谋；激起…的兴趣
intrinsic - 固有的，内在的
intuitive - 直觉的
inundate - 淹没
inure - 使习惯接受不好的东西
invective - 侮辱性的
inveigh - 激烈抗议，表示强烈不满
inveigle - 诱骗
inventory - (包含要点的)简介
inveterate - 根深蒂固的
invidious - 惹人反感的；羡慕嫉妒恨的
invigorate - 使精神，使强壮，鼓舞激励
invincible - 不可战胜的，不可超越的
invoke - 实施；产生，造成
irascible - 易怒的
irate - 极其愤怒的
iridescent - 五颜六色的
