irk - 使烦恼，使厌倦
ironclad - 非常坚固的，坚不可摧的
irradicable - 不能根除的
itinerant - 巡游的，巡回的
irrigate - 灌溉；冲洗
irritate - 刺激，惹恼
issue - (有争议的)话题，议题；(使)流出
jabber - 快而不清楚地说
jaded - 厌倦的，没兴趣没热情的
jape - 嘲弄
jargon - 行业术语
jarring - 刺耳的
jaundice - (因嫉妒或厌世而产生的)偏见
jaunty - 轻快的，活泼的
jejune - 无趣乏味的
jettison - 放弃，拒绝接受(想法，计划等)
jeopardy - 危险
jest - 轻浮的态度，戏谑
jibe - 意见一致
jingoist - 极端爱国激进分子(通常表现为好战的对外政策)
jitters - 紧张，不安
jocular - 搞笑的，欢乐的
jocund - 欢快的，高兴的
jog - 唤起
jolt - 惊吓
jot - 简要记录
jovial - 愉快的
jubilant - 喜悦的
judicious - 明智的，慎重的
juggernaut - 无法阻挡的力量，摧毁一切的强大力量
ken - 视野范围
kidnap - 绑架勒索
kindle - 点燃
kindred - 类似的；具有相似或相近的起源、本性或性质的
knack - 诀窍，聪明的做法
kilter - 平衡
knit - 连接，联系
knotty - 复杂的，困难的
kudos - 名望，名声；夸奖，赞扬
labile - 易变的，不稳定的
laborious - 勤奋的；费力的
labyrinthine - 迷宫似的，复杂曲折的
lacerate - 使非常痛苦
lackluster - 黯淡无光泽的
laconic - 简洁(以至于显得粗鲁或难以理解)的
lachrymose - 催人泪下的，悲伤的
lambaste - 严厉斥责
lament - 为…哀悼，表达痛苦或遗憾
libelous - 恶意中伤的，诽谤的
lampoon - 讽刺
languid - 没精打采的，虚弱的
