languish - 变得衰弱
languor - 懒惰；衰弱
lank - 细长瘦弱的；不僵硬的，柔软松弛的
lapse - 小过失
largesse - 慷慨
lash - 猛击，撞击
lassitude - 乏力，没精打采
latent - 潜在的，不活跃的
latitude - (行动或言论)自由
laudatory - 表示赞扬的
lavish - 奢侈的，大量的，无节制的；挥霍，浪费
leaven - 在…中加入轻松、活泼或变更的因素
leer - 一瞥，斜眼看
leery - 怀疑的，不信任的
legacy - 遗产
lucrative - 有利可图的
legion - 大量的
lenient - 宽大仁慈的
lethal - 非常有害的，致命的
lethargic - 没精打采的，行动迟缓的
levelheaded - 明智的
levity - 轻浮的态度，戏谑
liability - 责任
liberal - 思想前卫的；慷慨的，大方的
libertine - 放荡不羁者
licentious - 放荡的，性欲强的
liken - 显示相似，把…比作
limber - 可塑的，柔软的
limp - 柔软的，松散的
limpid - 透明清澈的
linger - 磨蹭，闲荡
lissome - 柔软的；敏捷的，轻盈的
list - (使)倾斜
lithe - 敏捷的，轻盈的；柔软的
loath - 不情愿的，讨厌的
loathe - 厌恶
lofty - 崇高的；自大的
loll - 偷懒，打发时间
lopsided - 不平衡的，不协调的
loquacious - 话多的
loutish - 粗鲁的
lubricate - 使润滑
lucid - 表达清晰的，简单易懂的
lug - 费力搬运
lugubrious - (故作夸张的)悲哀的
lull - 相对平静时期，间隙；使镇静，使安心
lullaby - 使镇静，使安心
lumber - 笨拙地行动；使负担(从而拖累)
luminary - 杰出人物
lurch - 蹒跚
lurk - 潜伏
