lush - 多产的
lustrous - 有光泽的
luxurious - 奢侈的
lyric - 如诗歌般流畅甜美的
macabre - 恐怖的
macerate - 浸化(以软化)
maculate - 使有斑点，弄脏；玷污，损坏
maelstrom - 混乱、动荡的局势
magnificent - 壮丽的
maladroit - 笨拙的
malaise - 不舒服
malcontent - 不满分子；不满的
malicious - 恶意的
malign - 恶意的；诽谤
malinger - 装病以逃避工作
malleable - 可塑的；易控制的
malodorous - 恶臭的
mandatory - 强制的
mangle - 弄砸
mangy - 卑劣的
mania - 热衷，狂热
manifest - 显然的，明显易懂的；显现，显露
manipulate - 巧妙处理；暗中操控
mannered - 不自然的，做作的
manumit - 解放(奴隶)
manuscript - 手稿
mar - 破坏，削弱
malfeasance - 非法行为
martinet - 纪律严明之人
marvel - 令人惊奇的食物；(因为壮观、美丽等而)表示惊讶
mash - 捣碎
masquerade - 面具，伪装；伪装，掩饰
mastery - 技艺超群，精通
matriculate - 录取
maudlin - 过于感伤的
maven - 专家
maverick - 特立独行之人；标新立异的，不合常规的
mawkish - 过于感伤的
meager - 贫乏的
mean - 卑贱的；吝啬的
meander - 闲逛，漫步
measly - 少得可怜的，微不足道的
measured - 深思熟虑的
meddle - 干涉，管闲事
mediate - 调解，调停
mediocre - 平庸的；质量中等偏差的
medley - 大杂烩，混合物
meek - 顺从的
meet - 合适的
mellifluous - (曲调)优美的
melodramatic - 感情夸张的，伤感的
