anarchist - 反抗权威的人
anathema - 令人讨厌的事物
ancillary - 次要的；辅助的，补充的
anecdote - 短小有趣的故事，段子
anemic - 缺乏力量、活力、精神的
anesthetic - 无感觉的，麻木的
animate - 有活力的；使有活力，支持
animus - 敌意
annoy - 不断烦扰
annul - 宣告无效，取消
anomalous - 不普通的，不平常的
anonymous - 匿名的
antagonize - 与…敌对，反对；激怒
antediluvian - 非常古老的；过时的
anterior - 前面的
antic - 滑稽可笑的
apathy - 缺乏兴趣，不关心
aphorism - 格言，警句
apocalyptic - 预言的，启示的；重要的，转折点的
apocryphal - 假的
apoplectic - 极度愤怒的
apostasy - 背叛
appall - 使惊恐
appeal - 申请；起诉
appealing - 吸引人的
applause - 鼓掌；认可
apposite - 相关的，合适的
appreciable - 可感知的，明显的
apprehension - 忧虑，恐惧；理解
apprise - 通知，告知
approbation - 同意
appropriate - 私自挪用；适当的
apropos - 相关的；关于，有关
apt - 恰当的，合适的；聪明的
archaic - 过时的，久远的
archetype - 典范，榜样
ardor - 狂热
arduous - 难以做到的，费劲的
anthropogenic - 人为的
arrest - 停止；逮捕；吸引(某人)注意力
arresting - 吸引人的
arrhythmic - 不规律的
arrogance - n．傲慢，自大
articulate - 清晰地表达；表达清晰的
ascendant - 有影响力的，主宰的
ascetic - 自制的(人)
aseptic - 消毒的，无菌的
askew - 不成直线的(地)，歪的(地)
aspect - 外表，容貌
asperity - (举止、性情)粗暴；(环境)艰苦
aspersion - 诽谤，中伤
