menace - 威胁，使处于危险
mendacious - 撒谎的，虚假的
mentor - 教导，指导
mercenary - 唯利是图的，贪婪的
mercurial - (情绪)善变的
merited - 应得的，理所当然的
mesh - 诱捕
mesmeric - 令人着迷的，难以抗拒的
metamorphose - (使)变形
metaphysical - 哲学上的，理论上的；非尘世的
meteoric - 流星般迅速而短暂的
methodical - 井然有序的，有条理的
meticulous - 极为谨慎的
mettle - 勇气；毅力，耐力
miff - 使恼怒
migratory - 迁移的
milk - 榨取(财富、信息等)
mime - 模仿
mimic - 仿真的，仿造的；模仿
minatory - 带来威胁的，有凶兆的
ministration - 帮助
mingle - 混合，结合
minimize - 将…减到最少；可以低估
mint - 无损坏的
minuscule - 极小的
minute - 仔细的，谨小慎微的；小的，不重要的
minutiae - 次要的细节，小事
mirage - 海市蜃楼，幻想
mire - 困境；使陷入困境，拖后腿
mirth - 欢乐，欢笑
misanthropic - 反人类的
misbehaving - 调皮的，行为不端的
mischievous - 调皮的，淘气的
misconstrue - 误解，曲解
miscreant - 恶棍，罪犯
misdemeanour - 轻罪
miserly - 吝啬的
manacle - 限制，给…制造困难
misgiving - 担忧，疑虑
mishap - 不幸之事
misrepresent - 误传，篡改
mite - 微小的东西，很少的钱
mitigate - 减轻痛苦，使缓和
majestic - 宏伟壮丽的
mockery - 鄙视，嘲弄；以嘲笑为目的的模仿
moderate - 使缓和；适度的，中庸的
modicum - 少量
mollify - 平息，抚慰，缓和
mollycoddle - 宠爱，溺爱
molt - 脱(羽、皮等)
momentous - 极重要的
