momentum - 动力；势头
mongrel - 杂种的，混血儿的
monochromatic - 单调无聊的
monologue - 独白
monotonous - 无聊的
montage - 大杂烩
moratorium - 延期，暂缓实行
morbid - 疾病的，疾病所指的；(思想性格)变态的
mordant - 尖酸刻薄的
moribund - 即将过时的
morose - 忧郁的
mosaic - 综合物，马赛克般的东西
monolithic - 大一统的
moth-eaten - 过时的
motile - 能动的
motivate - 刺激，激发
motley - 混杂的，富于变化的
mottle - 标记上杂色斑点的
multifarious - 多种多样的
mournful - 悲伤的
metaphor - 暗喻
muddy - 浑浊的，不清晰的；使难以理解
muffle - 使消声
mulish - 固执的
mumble - 说话含糊
mundane - 平凡的
munificent - 慷慨的
murky - 模糊的，晦涩的
murmur - 低声抱怨，发牢骚
mutate - (使)改变，(使)变异
mute - 不说话的，缄默的
mutter - 低声抱怨
myopic - 缺乏远见的，缺乏辨识能力的
myriad - 无限的，大量的
nadir - 最低点
naïve - 天真纯朴的
narcissistic - 自恋的
nascent - 新生的
natty - 整洁的，时髦的
nauseate - (使)厌恶，(使)作呕
nautical - 航海的
naysay - 拒绝，否认
nebulous - 模糊的
needy - 贫困的
nefarious - 极坏的，邪恶的
negation - 否定
negligent - 疏忽大意的
negotiate - 商量，谈判
neophyte - 初学者，新手
nerve - (坚强的)意志，勇气；给予勇气，鼓励
nettle - 惹怒
