neutralize - 使无效
nexus - 连结；核心，最重要的地带
nibble - 小口咬
nicety - 准确，精确
nil - 不存在，零
nip - 少量；小口吃喝
nitpick - 吹毛求疵
nocturnal - 夜间的
noisome - 恶臭的；非常令人厌恶的
nomad - 游牧的；居无定所的人
nominal - 不重要的
nonchalant - 冷漠的
nondescript - 平凡的，不吸引人的
nonentity - 不重要的人
nonplus - 使迷惑，使困窘
numinous - 神秘的，超自然的
notch - 通过努力获得
novel - 新奇的
noxious - 有害的，有毒的；产生强烈厌恶的
nuance - 细微的差异
nudge - 说服某人做某事
nugatory - 无关紧要的
nurture - 培育，培养
obtrusive - 扎眼的，难看显眼的
obdurate - 固执的；冷酷无情的
obedient - 服从的，顺从的
obeisance - 敬礼，尊重
obfuscate - 使困惑，使模糊
obligatory - 强制性的
obliging - 乐于助人的
oblique - 斜的
obliterate - 除去
oblivious - 不知道的，不知情的
obloquy - 谩骂，诽谤
obscure - 含义模糊的；平凡的，不知名的
obsequious - 谄媚的，奴性的
obsess - 迷住；使困扰
obstinate - 固执的
obstreperous - 不听话的，任性的
obstruct - 妨碍，给…制造困难
obtuse - 愚钝的
obviate - 排除，使不必要
occult - 难以理解的
odium - 憎恶，讨厌
offbeat - 不平常的
offhand - 即兴的，没有准备的
officious - 多管闲事的
offish - 冷淡的
off-key - 不寻常的，不合适的
ominous - 凶兆的
omniscient - 无所不知的
