onerous - 费时间花心思的
opaque - 晦涩的
opine - 表达观点；想，认为
opportune - 合适的，适当的
opprobrious - 辱骂的；臭名昭著的，令人鄙视的
outrageous - 过分的，难以容忍的；极坏的，极可怕的
orient - 使确定方向，使熟悉或适应
original - 创新的；最初的，最早的
orthodox - 传统的
oscillate - 犹豫，变化
ossify - (使)硬化，(使)僵化
ostentatious - 炫耀卖弄的
ostracize - 驱逐
oust - 驱逐
overweening - 傲慢的，专横的
outlandish - 古怪的，奇异的
outmaneuver - 以策略取胜
outset - 开端，开始
outwit - 欺瞒，以智取胜
overbearing - 专横傲慢的
overlap - (与…)部分重叠
overt - 明显的，公开的
overture - 前言；序曲
oxymoron - 矛盾修饰法
pacify - 使平静，安慰
padding - 夸张，废话
paean - 欢乐颂，赞扬
painstaking - 煞费苦心的
palatable - 感到愉悦满足的
palatial - 宫殿般奢华的
pall - 失去兴趣
palliate - 平息，减轻
pallid - 无生气的，缺乏活力的；苍白无血色的
palmy - 繁荣的
palpable - 明显的，易觉察的
palter - 欺骗；讨价还价
paltry - 无价值的，微不足道的
pan - 严厉批评
panache - 炫耀
pandemic - 大范围流行的
pandemonium - 喧嚣，骚动
panegyric - 赞颂之词，颂文
panoramic - 全景的
provenance - 来源，起源
paradigm - 典范，模范
paradise - 快乐，狂喜
paradox - 矛盾，悖论
paragon - 优秀模范；把…比作；显示相识
paramount - 最重要的
paranoid - 多疑的，对他人极端恐惧和怀疑的
paraphrase - 转述，意译，改写
