parch - 炽，烤；烤干
parenthesis - 间断
pariah - 被排斥或鄙视的人
parity - 相称，同等，平等
parody - (以嘲笑原作作者的)模仿作品，恶搞；模仿(以嘲弄)
paroxysm - (政治、社会领域的)大动荡
parrot - (机械地)模仿，复制
parry - 躲避(问题)
parsimonious - 过度节俭的，吝啬的
partial - 偏袒的，偏爱的；部分的，不完整的
particularize - 详述
partisan - 有偏见的人；偏袒的
pastiche - (带嘲讽的)模仿；大杂烩
partition - 分割，划分
patent - 显而易见的，明显的；专利
pathological - 不正常的，病态的
patina - 外表；(由内而外散发的)氛围，气场
patrician - 贵族，名门望族；贵族的，地位高的
patriot - 爱国者
patronize - 赞助；以高人一等的态度对待
paucity - 少量，缺乏
province - 职能范围
peck - 大量；(不情愿地)小口咬
pedagogue - 教育者，老师
pedant - 书呆子，墨守成规之人
predestine - 预先注定
pedestrian - 平庸无奇的，令人厌倦的
peep - 一瞥
peer - 同等地位的人，同辈；好奇地凝视
peeve - 打扰，惹恼
pejorative - 轻蔑的，贬低的
pellucid - 清晰明确的，易懂的
plaintive - 悲伤的
polymath - 学识渊博的人，博学者
penchant - 嗜好，迷恋
penitent - 悔过的
pensive - 沉思的，(尤指)哀思的
penury - 贫穷；吝啬，节俭
perambulate - 徒步穿越，走过
perceptible - 可察觉的
peremptory - 不容反抗的；傲慢的
parochial - 狭隘的
perfidy - 不忠，背信弃义
perforate - 打孔，穿透
perfunctory - 敷衍的，呵呵的
perimeter - 边界，界限
periodical - 周期性的，有固定间隔的
peripatetic - 巡游的，四处游历的
peripheral - 辅助性的
perish - 死亡，消亡
permanent - 永恒的
