permeable - 可渗透的
pernicious - 有害的
patchwork - 混合物(的)
perpetual - 永恒的，不断的
persecute - 迫害，折磨
persevere - 坚持不懈，不屈不挠
persiflage - 开玩笑
persistence - 坚持，持续
personable - 风度翩翩的，吸引人的
perspicacious - 极敏锐的，有洞察力的
perspicuity - 清晰明了
pertain - 有关联
pertinacious - 顽固的，固执地坚持的
pertinent - 相关的，恰当的
penance - 忏悔
peruse - 细读
pervade - 弥漫，充满
pessimistic - 悲观的
petition - 请愿，正式的申请；申请书；(尤指正式地)请求
petrify - 使僵化，使失去活力
petty - 细微的，不重要的
phenomenal - 不寻常的，非凡的
philanthropic - 博爱的，为他人着想的
philistine - 市侩(注重物质而鄙视智慧或艺术的人)
phlegmatic - 冷静的，无感情的，淡漠的
piddling - 微不足道的
piebald - 混合的，杂糅而成的
pigment - 颜料；给…上颜色
pilfer - 偷窃
precocious - 早熟的
pillory - 当众嘲弄
pilot - 初步的，试验性的；带领通过
pine - 渴望，奢望
pinnacle - 顶峰
pinpoint - 非常精确的；精确定位或确认
piquant - 令人振奋的
pique - 激起，刺激
pirate - 盗版，盗用
pithy - 精练的，简洁的
pitiless - 没有同情心的
pittance - 少量津贴
placate - (通过让步以)平息抚慰
placebo - 安慰性的事物
plagiarize - 剽窃，抄袭
plangent - 凄凉的，哀伤的
plastic - 可塑的
plateau - 高原；稳定时期，平台期
platitude - 陈词滥调
plausible - 可信的
plague - 瘟疫；折磨，使…痛苦
poignant - 令人感伤的
