plethora - 过量，过剩
pliable - 易弯曲的，柔软的；易受影响的，温顺的
pliant - 易弯曲的；顺从的
plight - 困境
plodding - 无聊的，单调乏味的
pluck - 敢于面对困难的勇气
plumb - 完全的，绝对的；仔细深入地检查；探索，探究
plummet - 突然下降
plump - 丰满的；鼎力支持，赞不绝口
plunge - 突然下降
polarize - 使分开对立，使两极分化
polemic - 争执
polished - 有教养的
politic - 合时宜的，明智的
pompous - 浮夸的；傲慢的
ponderable - 值得考虑的，有价值的
ponderous - 沉重的
pontificate - 傲慢地做或说
pore - 仔细浏览，仔细研究
porous - 多孔可渗透的
portentous - 预兆性的，凶兆的
poseur - 故作姿态、不真诚的人
posit - 假定，断定
postulate - 假定，假设；假定为真
posture - 故作姿态，装模作样
potable - 饮品，尤指有酒精饮料；适于饮用的
potentate - 有权势的人
potentiate - 加强，激活
pout - (尤指撅嘴或板着脸)表示不悦
practitioner - 职业人士
premium - 高端的
prate - 闲聊，空谈
preach - 传道，布道
precarious - 危险的，不稳定的；可疑的，不明确的
precedent - 先例，前例；先前的
ploy - 计策，手段
precipitate - 匆忙的；促使，导致
precipitation - 仓促；沉积物，尤指降水
precipitous - 非常陡峭的；匆忙的
preclude - 预先阻止
precursor - 先驱者，先导
predecessor - 前任，先辈
predilection - 爱好，偏袒
preeminent - 优秀的，重要的
preempt - 预先占有
preen - 打扮修饰
preface - 序言
pregnant - 重要的，意味深长的
premeditate - 预谋
preoccupation - 非常关心，全神贯注
preponderant - 占优势的，更重要的
