prepossessing - 给人好感的，有魅力的
preposterous - 荒谬的，不符合常理的
presage - 征兆；预示，预言
prescience - 预知，先见
prescription - 处方；规定，传统的规矩
primitive - 原始的
prestige - 声望，威望
presumptuous - 傲慢的
pretense - 虚假，伪装；自大，优越感
preternatural - 超乎寻常的
prognosis - 预兆
prevalent - 流行的，普遍的
prevaricate - 支吾其词，撒谎
primordial - 原始的，最初的
primp - 精心打扮
peddle - 叫卖，兜售
pristine - 纯净的，质朴的，未被文明腐蚀的
privation - 缺乏，穷困
probe - 深入调查
probity - 正直
proclivity - 癖性，偏好
procrastinate - (因为懒散)拖延
procure - 获得，取得
prod - 促使…行动
prodigal - 挥霍的；败家子
prodigious - 巨大的；惊人的，了不起的
profane - 亵渎
proffer - 献出，提供
proficient - 熟练的，精通的
profligate - 挥金如土的，挥霍的；败家子
pushover - 容易做的工作
profusion - 丰富，大量
prohibitive - (价格高得)抑制购买的
proliferate - 快速繁殖；激增
prolix - 啰嗦的，冗长的
prologue - 序言
prolong - 延长，拖延
promulgate - 正式宣布
proofread - 校对
propagate - 传播，宣传
propensity - 倾向，癖好
prophetic - 预言的，预示的
propitiate - 抚慰，劝解
propitious - 吉祥的
proponent - 建议者，支持者
propriety - 适当，得体
prosaic - 单调的，常见的
proscribe - 禁止，排斥
prosecution - 实行，执行
proselytize - (使)改变信仰
prospect - 探查，勘探
