prosperous - 成功的，繁盛的
prostrate - 平躺(的)使平躺；衰弱的使衰竭
protean - 善变的；多才多艺的
protocol - 正确的礼仪规范
protract - 延长，拖长
protrude - 突出
protuberant - 隆起的，凸出的
provident - 有远见的；节俭的
providential - 天意的，幸运(的)
provincial - 狭隘(的)
provisional - 临时的
provisory - 有附带条件的；临时的
provoke - 激怒；驱使，激起
prowess - 英勇，勇敢
prowl - 巡游以猎取食物；徘徊
prude - 过分正经的人：一个过分关心自己是否得体、谦逊或正确的人
prudent - 明智的；小心谨慎的，审慎的
prudish - 过分守礼的
prune - 修剪；修整
pry - 刺探，打听
pseudonym - 假名，笔名
putative - 推测的，假定的
pecuniary - 金钱上的
puckish - 淘气的，顽皮的
puerile - 幼稚的，不成熟的
puissance - 权力
pulchritude - 美丽
pulverize - 将…研磨成粉；将…彻底摧毁
permeate - 弥漫，渗透
punctilious - 注意细节的，一丝不苟的
pundit - 权威人士，专家
pungent - 辛辣的，讽刺的
puny - 微小的，弱小的
purport - 声称，打算
purlieu - 常去的地方；临近的地区
purloin - 偷窃
purvey - (大量)供给，供应
pusillanimous - 懦弱的，胆小得令人鄙视的
quack - 骗子医生，江湖郎中
quaff - 大口地喝
quail - 胆怯，畏缩
qualify - 限定；使有资格，使有能力
quandary - 困惑，窘境
quarantine - 隔离
qualm - 担忧，不安
quash - 镇压，阻止
quirky - 古怪的，奇葩的
quell - 压制；使平静，使安静
quench - 熄灭；使满足
querulous - 抱怨的，爱发牢骚的
quibble - 吹毛求疵
