quiescent - 平静的，静止的
quixotic - 不切实际的，空想的
quota - 配额，限额
quotidian - 每日的；平凡的
rabble - 混乱的人群；暴民；下层民众
rabid - 狂热的，不冷静的
racy - 活泼生动的
raffish - 低俗的
recapitulate - 概括，摘要
rage - 暴怒
ragged - 凹凸不平的，不光滑的
rail - 怒骂，猛烈抨击
rakish - 放荡的，行为不检点的
ramble - 漫谈；长篇大论(并经常离题)地说或写
rambunctious - 喧闹的，骚乱的
ramshackle - 摇摇欲坠的
rancor - 敌意，深仇
random - 随机的，随意的
rankle - 激怒
rant - (尤指长时间的)训斥，责骂
rapacious - 过度贪婪的
rapport - 和睦，友好
rapprochement - 和睦，友好
rapscallion - 流氓，恶棍
rapt - 狂喜的，狂热的
rarefy - 使稀薄
rash - 草率的，仓促的
raspy - 声音刺耳的
ratify - (官方地)认可，批准
ratiocination - 推理
ration - 按比例分配
rational - 理性的
rave - 狂热赞扬；(发疯般地)怒吼
ravel - 解开，松开；阐明；使纠缠，使复杂化
ravish - 使陶醉，使沉迷
raze - 摧毁，粉碎
row - 争吵，争执
reactionary - 反对变革的，极保守的
ream - 怒斥，训斥
ramification - 影响，结果
reassure - 使安心，打消疑虑
rebuff - 严词拒绝
recalcitrant - 顽抗的，不顺从的
recant - 撤回，放弃，改变
recessive - 内向的，内敛的
recidivate - 回到原先的习惯，尤指重新犯罪
reciprocate - 报答，回报
reckless - 不考虑后果的，大胆鲁莽的
recluse - 隐士隐居的，不爱社交的
recoil - 退却，畏缩
reconcile - 使和解，协调
