aspirant - 有抱负者，有野心者
assent - 同意
assert - 断言，肯定地说出
assertive - 自信的
assess - 评估(重要性、尺寸、价值等)；征收费用(如罚款)
assiduous - 勤勉的，专心仔细的
assuage - 缓和，减轻
astounding - 令人吃惊的，出乎意料的
astute - 机敏的，有洞察力的
asunder - 分离地
asylum - 收容所，保护所
asymmetrical - 不平衡的，不对称的
atone - 赎罪，弥补
atrocious - 极坏的，极其残忍的
attenuate - 降低(数量、力量、价值)
audacious - 大胆的，(但往往)愚勇的
augur - 预言家预言
authentic - 真实的，非仿造的
authority - (某领域的)权威人士；管辖权，控制
autocracy - 独裁政府
autonomy - 政治上的独立；自我主导的自由，(尤其是)精神独立
avarice - 贪财，贪婪
aver - 声称为真
averse - 反对的
avid - 急切渴望的
awash - (如洪水般)泛滥的
awe - 敬畏
awkward - 缺乏灵活性和技巧的；(处理问题)缺乏手段和智谋的
avant-garde - (尤指艺术上的)先锋派
awry - 出差错的(地)
axiomatic - 不言自明的
babble - 发出含糊无意义的嘟囔声，胡乱说
backhanded - 间接的
badger - 不断纠缠或骚扰
badinage - 打趣，善意的玩笑
bait - 引诱；诱饵
bale - 痛苦，悲哀
baleful - 有害的
balk - 阻碍；不愿接受，拒绝
balky - 不服管束的，倔强的
balderdash - 胡言乱语，废话，无意义的话
balloon - 迅速增加
balm - 香油，止痛膏；安慰物
banal - 非原创的，陈腐的
bane - 有害的物质
banish - 驱逐出境
banter - 幽默、打趣的(地)谈话
barb - 尖锐而严厉的批评
barbarous - 野蛮的
barefaced - 公然的
bargain - 协议；讨价还价
