recondite - 深奥的，难解的
reconnoiter - 侦察，勘查
reconstitute - 重建，(尤其是通过加水)使复原
repentant - 悔过的
rectitude - 正直
recumbent - 躺着的
recuperate - 恢复(健康或力量)，康复
redolent - 芳香的
redoubtable - 杰出的，值得尊敬的；可怕的
redundant - 多余的，冗余的
reel - 感到眩晕
referee - 仲裁者；裁判员(就纠纷或争议)给出意见
refine - 改善，改进
reflect - 反映，显露；思考
refractory - 倔强的，不顺从的
refulgent - 辉煌的，灿烂的
refute - 否认
regenerate - 使重获新生，使焕然一新
regimen - (政治上的)统治
regress - 后退；退化，恶化
rehabilitate - 使复原，使康复
rehearsal - 排练，彩排
reign - 统治权占统治地位或盛行
rein - 抑制，限制抑制，控制
reiterate - 重申
rejoice - 欣喜，喜悦
relapse - 重蹈覆辙，再犯
rehash - 重复，老调重弹
relentless - 残酷的，无情的；固执的，不肯妥协的
relevant - 有关系的，重要的
reminiscent - 怀旧的，引发回忆的
relinquish - 放弃(职位、权力等)
relish - 喜好，偏好享受，喜欢
reluctant - 不情愿的，反感的
remiss - 疏忽的，不留心的
resent - 怨恨，憎恨
remonstrance - 抗议，抱怨
remorse - 懊悔，悔恨
remunerate - 支付报酬，补偿
rend - 撕裂，猛拉
renegade - 背教者，叛徒
renounce - (正式地)放弃
renovate - 修复，维修
repartee - 打趣，善意的玩笑
repatriate - 遣返
repeal - 撤销，废除(法律等)
repel - 使厌恶
repertoire - (技术、设备或原料等的)详单
repine - 抱怨，表达不满；渴望
replete - 充满……的，富于……的
repose - (劳作后的)休息休息；平静，宁静
