reprehend - 谴责，责难，批评
repress - 镇压；阻止(正常的表达、活动或发展等)
reprieve - 对…暂缓处刑，免罪
reproach - 批评，责备
reprobate - 堕落者，道德败坏的人堕落的，放荡的
reproof - 批评，反对
reprove - 温和地责备，警告
repudiate - 否认
repugnant - 令人厌恶的
repulse - 使厌恶，排斥
repute - (尤指好的)名声，名誉
requite - 酬谢，报答；报仇
requisite - 必需品必不可少的，必备的
rescind - 废除，取消
reserved - 内向的，缄默的
residue - 剩余物
resign - 辞职，放弃(职位)
resilience - 恢复能力
resolute - 坚定的
resonant - (声音)洪亮的，共鸣的
resourceful - 有创造力的，机智的
respite - 间歇，休息
retroactive - 有追溯效力的
resplendent - 华丽辉煌的
responsive - 反应的；敏感的
restive - 急躁的，忧虑的
restless - 不平静的
revelation - 爆料，揭示
resurgence - 复兴
resuscitate - 使复活，使苏醒
retainer - 家仆
retaliate - 报复，反击
retard - 减速，延迟
repetitious - 重复的，反复的
reticent - 沉默不语的
retort - (尤指机智的)回应，回答
retouch - 润饰，改进
retract - 收回，否认
retrench - 削减开支
retribution - 报偿，报应
retrograde - 倒退的退步，退化
retrospective - 回顾的
revel - 享乐，陶醉
revenge - 报复，复仇为…复仇
revere - (尤指对神的)尊崇，尊敬
resonate - 有重要性
revive - 再获新生
revoke - 撤回，宣告无效
revolt - 使厌恶，使反感；反叛
ribald - (举止、言语)下流粗俗的
rickety - 不稳的
