restorative - 有益健康的
ridicule - 嘲笑
rife - 丰富的，普遍的
rift - 分裂，不和
rile - 刺激，惹怒
ripen - 使成熟，变成熟
riot - 喧闹，暴乱
rite - 惯例，仪式
rive - 撕开
riveting - 吸引人的，极迷人的
renaissance - 复兴
robust - 精力充沛的；强壮的，健康的
roil - 激怒
rosy - 乐观的
rookie - 新兵；新手；菜鸟
rote - 死记硬背
rationale - 基本原理，解释
rouse - 激起，煽动；唤醒
royalty - 皇家身份；版税；专利权税
rubicund - 红润的，健康的
rudimentary - 初始的，未发展的；最根本的，基础的
rue - 后悔，遗憾
ruffle - 使粗糙；扰乱，打扰
ruminate - 反复思考
rumple - 打乱，使不整齐
revision - 修订
runic - 神秘的
rupture - 打破；打碎，破裂
ruse - 诡计
rustic - 乡下人；头脑简单的人；乡村的；粗俗的
rustle - 快速地行动
sabotage - 妨害，破坏；从事破坏活动
saccharine - 像糖一样的，有甜味的；做作的，矫情的
sacrilege - 亵渎圣物
saddle - 使某人有负担
safeguard - 保护措施；保护
sage - 智者
salient - 显著的，最突出的
salubrious - 有益健康的
salutary - 有益健康的；有利的，利好的
salutation - 赞扬
salvage - (从灾难中)抢救
salve - 减轻，缓解
sanctify - 使神圣，将…敬为神
sanctimonious - 假装虔诚的
sanction - 批准，同意，认可
sanctuary - 避难所
showcase - 展示(优点)
sanguine - 乐观的，确信的
sanitary - 健康的，清洁的
