sap - 削弱；健康，活力
sapient - 聪明的，有洞察力的
sarcasm - 讽刺，轻蔑
sartorial - 裁缝匠的，裁缝的
sate - 使饱足，充分满足
satiate - (使)饱足(的)，过分满足(的)
scandalous - 引起反感的，丢脸的
satirize - 讽刺
saturate - 使饱和，浸透
saturnine - 忧郁的，阴沉的
saunter - 闲逛，漫步
savant - 博学之士，学者
savory - 令人愉悦的
savvy - 老练，机智；有见识的，精明能干的
scads - 许多，大量
scant - 不足的，缺乏的
scathing - 尖酸刻薄的
schism - 不一致
scintillate - 闪耀
seditious - 煽动性的，意在制造混乱的
scission - 切断，分离，分裂
scoff - 嘲笑
scorch - 炙烤，烘干
scorn - 轻蔑，鄙视，不屑
scotch - 停止
scour - 搜查
scowl - 皱眉(表现出不高兴)
scrappy - 好斗的，好吵架的
scrap - 抛弃
scrawl - 乱涂，潦草地写
scribble - 潦草地书写，乱写
scrupulous - 正直的；一丝不苟的
scrutable - 可以理解的
scrutinize - 仔细检查
scuff - (使)磨损
scurrilous - 说粗话的
scurvy - 下流的，让人鄙视的
seamy - 肮脏的，堕落的
secluded - 僻静的，隐蔽的
secrete - 隐藏；分泌
sedate - 淡定的，安静地
sedentary - 固定不动的
seduce - 劝说(使不忠，使不顺从)，诱…误入歧途
sedulous - 勤奋认真的
seemly - 得体的，遵守礼节的
segment - 分割；部分
self-abasement - 自卑，自谦
self-absorbed - 自恋的，自私的
seminal - 创新的
sensation - 轰动事件
