sift - 审查
showmanship - 擅长表演、展示的技巧
sepulchral - 阴沉的；丧葬的
septic - 腐败的，感染的
sequela - 结果
sequester - 使隔绝，分离
sere - 干枯的，凋萎的
serendipity - 意外发现珍奇(或称心)事物的本领
serene - 安静的
sermon - 布道，说教
serpentine - 弯曲的
self-defeating - 适得其反的，自我拆台的
serried - 密集的
servile - 低下的，卑屈的
shifty - (显得)狡诈的，(显得)欺诈的
shackle - 束缚；限制，阻碍
shadow - 偷偷尾随；遮蔽，(使)变暗
stale - 陈旧乏味的
sham - 掩饰，假装；虚假的
shiftless - 胸无大志的，懒惰的
shipshape - 井然有序的
shirk - 逃避，规避
shoal - 浅的
shopworn - 陈旧的
shred - 少量
shrewd - 精明的，机敏的
shrink - (在数量或价值方面)降低，减少
shroud - 将…从视线中隔离，遮蔽
shrug - 轻视，忽略
shun - 避开，避免
sidestep - (通过逃避而)不遵守
signal - (在重要性、成就方面)非同寻常；给出信号
simpleton - (缺乏常识的)笨蛋
simulate - 假装，模仿
self-perpetuating - 自续的，能使自身永久存在的
sensuality - 感官享乐
sinecure - 拿钱不干事的职务；闲差事
sinew - 活力，力量
singe - 轻微烧焦
sinuous - 蜿蜒的，迂回的
snag - 障碍
sacrosanct - 极为神圣的，不可侵犯的
scourge - 祸害
skimp - 缺乏的，不足的；节省花费，吝啬
scruple - (良心上的)不安
skirt - 绕行，避开
slack - 松弛的；疏忽的，大意的
slake - 使满足
slant - (看待问题、思考的)角度，看法；倾斜的
slate - 列入名单，计划，安排
