slew - 大量，许多
slight - 不重要的；轻蔑，看不起；忽略，疏忽
sling - 投掷
slippery - 光滑的；意义不明确的
slipshod - 粗心的，随意的
sloppy - 邋遢的，不整洁的；混乱的
sloth - 怠惰，懒惰
slouch - 缓慢行走
slovenly - 邋遢的，不整洁的
sluggard - 懒人
sluggish - 缓慢的，迟缓的
slumber - 睡着
slur - 耻辱；疏忽，忽略
sly - 狡猾的
smarmy - 虚情假意的，过分恭维的
skullduggery - 欺诈，诡计
smattering - 少量
smirk - (自鸣得意地)笑
smother - 抑制(表达、说出)，压制
smug - 自大的，自鸣得意的
smuggling - 走私，私运
snare - 无法逃脱的困境；捕捉
snarl - 纠缠，纠结
sneer - (轻蔑地)嘲笑
snobbish - 谄上傲下的，自大的
snub - 轻视，不理睬
soak - 使…湿透
sober - 严肃的；节制的
sodden - 湿透的；使…湿透
solace - 安慰；安慰，安抚
solder - 连接，联合
solemnity - 庄严，严肃
solicitous - 为他人操心的，体谅他人的
solid - 有理有据的
soliloquy - (尤指自言自语的)独白
solitude - 孤独，避世
solvent - 有偿付能力的；溶剂
somatic - 肉体的
somber - 悲伤的，不愉快的
somnolence - 瞌睡，嗜睡
slapdash - 马虎的
soothe - 带来慰藉，安慰
sop - 安慰物；浸湿，湿透
sophism - 假推理，诡辩
sophisticated - 精明的，老于世故的；复杂的
soporific - 催眠的药剂，安眠药；催眠的
sordid - 肮脏的，不干净的；卑鄙的
sound - 牢固的，不可动摇的；健康的，强壮的；(逻辑上)严谨的
sparse - 稀疏的，稀少的
spartan - 简朴的，节约的
