spat - (小的)争吵
spate - 大量
sleek - 时髦的，优美的
specious - 似是而非的，欺骗性的
speck - 小点，少量
spectator - 观众，目击者，旁观者
spectrum - 光谱；范围，系列
speculate - 推测，揣测
spendthrift - 挥霍着，败家子；挥霍的，不节俭的
spent - 精疲力竭的；用废的
slump - v暴跌，急剧下降
spiny - 棘手的，麻烦的
spleen - 怒气，怨恨
splice - 接合，叠接
spontaneous - 自发的，不经思索的
spoof - 轻松幽默的模仿，小恶搞
sporadic - 断断续续的
sprawl - 杂乱无序地发展，蔓生，蔓延
sprightly - 活泼的，充满活力的
spur - 刺激物；刺激，激励
spurious - 假的，伪造的
spurn - 摈弃，拒绝
sanity - 心智健全，神智正常
squalid - 污秽的，肮脏的
squall - 尖叫
squander - 浪费
squat - 又矮又胖的
soft-pedal - 降低…的力度
squelch - 压制，镇压(运动)
secede - 脱离，退出(组织，团体，联盟等)
stalwart - 坚定的
stamina - 耐力
stammer - 口吃，结巴
startle - 使吓一跳，使大吃一惊
static - 静态的，停滞的
stature - 高度，身高；才干，水平
steadfast - 坚定的，忠诚的
stealth - 秘密的
steep - 陡峭的；过分的，过高的
stench - 臭气，恶臭
stentorian - 声音洪亮的
sterile - 贫瘠的；无菌的
stickler - 坚持细节的人，一丝不苟的人
stiff - 僵硬的，无法弯曲的；艰苦的，费力的
stifle - 抑制(声音、呼吸等)；阻止，扼杀
stigma - 耻辱，污名
stint - 吝惜，节省
stingy - 小气的，吝啬的
sequel - 结果
stipulate - 规定，特定要求
