stitch - 突然剧痛
stock - 普通的，常备的
sectarian - 狭隘的
stodgy - 平庸的，乏味的
stoke - 增大，促进
stoic - 隐忍的，冷静的
stolid - 无动于衷的，感情麻木的
stomach - 容忍
stonewall - 拒绝(合作)，阻挠
stouthearted - 勇敢的
stratagem - 谋略，策略
sonorous - 声音洪亮的
strand - 遗弃，使置于困境
stratify - 讲…分成各种等级
stray - 漫无目的的
strenuous - 有活力的；艰苦的，费力的
striate - 加条纹
stricture - 责难，批评
soothsayer - 预言家
strident - 刺耳的
strike - 攻击；击打；袭击，攻击；撞击
stringent - 严格的
strip - 脱衣，剥去
strut - 趾高气扬地走
spike - 激励
stultify - 使无效，抑制
stupor - 迟钝，麻痹，无知觉
stunt - 阻碍(成长)
sturdy - 强健的，结实的
stygian - 极其暗的
stymie - 阻碍
subdue - 使顺从，征服
subject - 取决于(其他因素的)，受制于
subjugate - 征服，镇压
sublime - 崇高的，庄严的
subliminal - 下意识的，潜在意识的
submerge - 使淹没
submissive - 服从的，顺从的，恭顺的
subordinate - 下级的；次要的；征服
subservient - 奉承的，屈从的
subside - 下陷，下沉，减弱
subsidiary - 次要的
subsidy - 补助金，津贴
substantial - 有重大意义的
substantiate - 证实
substantive - 本质的，关键的
subterfuge - 诡计
subtle - 微妙的，难以感知的
subvert - 颠覆
succinct - 简明的，简洁的
