succor - 救援，援助
suffocate - 使窒息
suffuse - (色彩等)弥漫，染遍，充满
sulk - 生气，愠怒
sullen - 闷闷不乐的
secular - 世俗的，尘世的
summit - 顶点
summon - 召集，召唤
sumptuous - 豪华的，奢侈的
sunder - 分裂，分离
supercilious - 高傲的，傲慢的
superficial - 表面的，肤浅的
superfluous - 多余的，过剩的
stagnant - 停滞不前的
supine - 懒散的，倦怠的，消极的，漠不关心的
supple - 易弯曲的，柔软的
supplant - 排挤，篡夺…的位置
supplement - 增补，补充
supplicate - 恳求，乞求
supposition - 猜想，推测
suppress - 用暴力终止，镇压；封锁，删除
surcharge - 过高收费
surfeit - (使)过量，(使)饮食过度
surrender - 交出，放弃，投降
surreptitious - 偷偷摸摸的，保密的
susceptible - 容易受伤害的
suspend - 暂停，中止
suture - 缝合
svelte - (女人)体态苗条的，优雅的
swagger - 自夸，吹嘘
swear - 咒骂；宣誓
sweltering - 酷热的
swerve - 突然改变方向
sterling - 优秀的
swindle - 欺骗，骗取
sybarite - 沉溺于奢侈逸乐者，酒色之徒
sycophant - 马屁精
syllabus - 提纲，摘要；课文，演讲或研究课题的概要或提纲
syllogism - 由一般到个别的推理，演绎
symbiosis - 共生关系
symmetry - 对称
synchronous - 同时期的，同步的
synergic - 合作的，1+1>2的
synonymous - 同义的
synopsis - 摘要，概要
synthesis - 合成，综合
tacit - 暗示的
taciturn - 沉默寡言的，话少的
tackle - 着手处理
tact - 机敏，精明，不冒犯
