tactile - 有触觉的，能触知的
tactless - 不机智的，笨拙的
tilt - 倾斜；倾斜
taint - 使(品质)污损
tamper - 恶意窜改，损害
tangent - 离题(的)，不相关(的)
tangible - 可感知的
tangy - 刺激的
tantalize - 激起，挑逗，引诱
tantamount - 等价的，与…相等的
tantrum - 勃然大怒，发脾气
taper - 逐渐减少，减弱
tardy - 缓慢的，迟缓的
tarnish - 玷污
tasty - 美味的；令人愉悦的
tatty - 破旧的，褴褛的
taunt - 嘲弄性质疑，挑衅
taut - 紧绷的
tawdry - 俗丽的，花哨而庸俗的
taxing - 繁重的，费力的
tedious - 冗长乏味的
teeter - 蹒跚，不稳定地行走；犹豫不决
teetotalism - 禁酒
telling - 有效的，显著的
temerity - 鲁莽，冒失
temporize - 行动躲躲闪闪以争取时间、躲避争论等，打哈哈
temperate - (言行举止)有分寸的；有节制的
tempestuous - 突然的，剧烈的
tenable - 有据可依的，无懈可击的
tenacious - 顽固的，不屈不挠的
tendentious - 有偏见的
tender - 正式提出；考虑周到的，关心同情的
tenuous - 没有实际内容的，空洞的
tepid - 不太热心的
terminology - 专业术语
terminus - 终点，终点站
traumatic - 造成创伤的，痛苦的
terse - 简洁的，简明的
testimony - 证词，声明
testy - 易怒的，暴躁的
tether - (用绳、铁链)栓系，束缚
theatrical - 做作的，夸张的，矫揉造作的
therapeutic - 治疗的，有疗效的
thorny - 棘手的
threadbare - 陈腐的
throng - 大量聚集
thwart - 阻挠
ticklish - 易怒的；棘手的，对技巧要求高的
tiff - 小争吵
tightfisted - 吝啬的
