baroque - 复杂，装饰华丽的
barrage - 有压倒之势的言语
barren - 无效的；贫瘠的
barricade - 障碍物；用障碍物阻止通过
barter - 以物换物
beguile - 欺骗
bathetic - 平凡的，陈腐的
befuddle - 使困惑
bedeck - 装饰，点缀
belabor - 严厉批评；喋喋不休
beleaguer - 使困扰，使烦恼，使消沉
belie - 掩饰；与…相对立；与…相矛盾
bellwether - 领导者，带头人
beneficent - 仁慈的，好慈善的；(对个人或社会)有益的
benign - 无害的
berate - (长时间)严厉指责
beseech - (急切地)恳求
besmirch - 诽谤，玷污
bifurcate - (使)分成两支
bigot - 固执己见者，有偏见的人
bland - 无趣的
blandishment - 甜言蜜语，讨好某人的话
blasé - (过度放纵之后)厌倦享乐的，腻烦的
blast - 爆炸；炸裂，爆破；斥责，抨击
blatant - (让人生厌地)惹人注目的
blazon - 使知名；修饰，装扮
blemish - 缺点，污点；损害，玷污
blight - (使)枯萎；损害
bliss - 极度快乐
blithe - 愉快高兴的；无忧无虑的；漫不经心的
blueprint - 事先计划
blunder - 过失；犯错误
blunt - 使变钝；直率的
blur - (使)变得朦胧，(使)变得不清楚；使不易理解
blurt - 突然说出
bluster - 狂妄自大地大声说；喧闹的状态
boggle - (因为怀疑、恐惧)犹豫
boisterous - 喧嚷的，吵闹的
bolster - 支撑(物)；鼓励，使有精力
bombast - 夸大的言辞
bonhomie - 温和，和蔼
boo - 嘘(以表示不满或嘲笑)
boon - 恩惠，福利
boorish - 粗鲁无礼的
bootless - 无用的
bound - 界限；投入的，坚定的
boycott - 联合抵制，拒绝参与
bracing - 令人振奋的，给人带来活力的
brake - 刹车
brash - 愚勇的，鲁莽的
brassy - 厚脸皮的，不知羞耻的
