timeworn - 陈腐的
timid - 胆小的，不自信的
timorous - 胆小的
tinge - 给…着上少量的色彩
tinker - 乱修，乱调整
truism - 陈词滥调
tirade - 长篇抨击性演讲
toady - 马屁精；拍马屁
tonic - 滋补的，有益健康的
topsy-turvy - 混乱的
torpid - 麻木的，没有知觉的
torpor - 缺乏兴趣；(肉体或精神上的)迟钝，懒散
torrential - 急流的
torrid - 酷热的；热情的，情感深厚的
tortuous - 转弯抹角的
tout - 极力赞扬
toy - 草率或不认真地对待
tractable - 易驾驭的，温顺的
tranquility - 宁静，淡定
transcend - 超越，超过极限
transfigure - 使改变外观
transgress - 违背，犯错
transient - 短暂的，瞬时的
transitory - 短暂的
translucent - 透明的
transparent - 没有歧义的，清晰易懂的
travail - 辛苦劳动
traverse - 横穿
travesty - 拙劣的、嘲弄性模仿
treacherous - 背叛的
trenchant - (言辞)一针见血的
trepidation - 恐惧，战栗
trespass - 非法侵入；违反，冒犯
tribute - 称颂，颂词
trickle - 一滴一滴地流，缓慢地流
trite - 陈腐的，陈词滥调的
trivial - 无足轻重的，不重要的
truant - 逃避责任(的)；逃避责任者
truce - 休战，休战协定
truculent - 好战的，好斗的
trudge - 吃力而笨拙地走
trumpet - 大声说出或宣告
truncate - 截短；缩短(时间、篇幅等)
tremendous - 极大的
tumult - 骚动，暴动
turbid - 混浊的
turbulent - 动荡的
turgid - 浮夸的，过分装饰的
turmoil - 骚动，混乱
turncoat - 叛徒
