turpitude - 卑鄙
trope - 比喻；陈词滥调
typo - 打字错误
tyro - 新手，业余爱好者
ubiquitous - 无所不在的，普通的
unassailable - 无可争辩的，无法否认的，不可亵渎的
uncanny - 离奇的，奇异的
uncouth - 粗俗的，没有品味的
unctuous - 油嘴滑舌的，谄媚的
upbeat - 心情好的；给人希望的，象征好运的
undergird - 加强，巩固…的底部
usher - 开启
underscore - 强调
understate - 保守陈述
undue - 过度的，过多的
unexceptionable - 无懈可击的
unflappable - 镇定的，从容不迫的
ungainly - 笨拙的，不雅的
unimpeachable - 无可置疑的
unkempt - 凌乱的，无序的
unlettered - 未受教育的，文盲的
unpretentious - 低调的，谦逊的；坦诚的，自然的
unflagging - 不懈的，不知疲倦的
unsung - 被埋没的，不知名的
unruly - 难驾驭的，不守规矩的
untenable - 防守不住的，站不住脚的
untold - 数不清的
untoward - 倒霉的，不吉利的；难以驯服的，难以驾驭的
unwitting - 不知道的，未觉察的
unwonted - 不习惯的，不寻常的
upbraid - (严厉地)谴责，责骂
uphold - 支持，赞成
urbane - 彬彬有礼的，文雅的
usurp - 篡夺，篡位
univocal - 含义明确的
vaccinate - 预防接种疫苗
vacillate - 犹豫不决；摇动，摇摆
vacuous - 茫然的，愚蠢的
vagary - 不可预测的思想或行为
vague - 表达不清的；轮廓不清晰的
valediction - 告别词
valiant - 勇敢的，英勇的
versed - 熟知的；精通的
vanquish - 打败，征服
vapid - 无趣的，乏味的
vaporize - 彻底消灭
variance - 不一致，不和谐
variegated - 杂色的，斑驳的
varnish - 粉饰(令人不悦的东西)
valorize - 提升，赞美
