vaunt - 吹嘘
veer - (使)转向，(使)改变航线
vehement - (情感)强烈的，热情的
venal - 贪污受贿的
vendor - 小贩，商贩
veneer - 粉饰(不好的东西)
venerate - 尊敬
venial - 可宽恕的
venom - 恶意，恶毒的用心
veracious - 诚实的，说实话的
verbatim - 逐字地，一字不差地
verbose - 冗长的，啰嗦的
verdant - (因长满植物而)翠绿的，郁郁葱葱的
verify - 校验，证实
verisimilar - 似乎真实的
vile - 丑陋的；(道德上)可鄙的，卑鄙的
vernacular - 方言；非正式的，口头的
versatile - 多才多艺的，全能的
verse - 使精通，使熟悉；诗歌
vertigo - 眩晕
verve - 活力，热情
venue - 场地
vestige - 微小的遗迹，小痕迹
vocation - 职业
veteran - 老兵；有丰富经验的人；经验丰富的，资深的
veto - 否决，禁止
vex - 使烦恼，使恼怒
viable - 可行的
vicarious - 代理的，取代的
vicious - 凶恶的，恶毒的
vicissitude - 自然变化，变迁兴衰
victimize - 使受骗
vigilant - 警醒的，警惕的
vignette - 简介，短文
vigorous - 精力旺盛的
vilify - 诽谤，辱骂
vim - 活力，精力
vindicate - 为…平反，为…辩护，使无罪；证明，证实
vindictive - 复仇的，有寻仇倾向的
virtuoso - 艺术鉴赏家，专家；经验丰富的，技艺精湛的
virtuous - 品德高尚的，正直的
virulent - 有毒的
viscid - 有粘性的
viscous - 粘稠的，粘的
visionary - 空想的，不切实际的；有远见的
vitality - 活力，生命力
vitiate - 削弱，损害
vitriolic - (言辞)刻薄的
vituperate - 谩骂，责骂
vivacious - 活泼的，快活的
