vociferous - 喧哗的，大叫大嚷的
volatile - 多变的
volition - 意志，自愿选择的行为
voluble - 健谈的，话多的
voluminous - 卷数多的，大量的，庞大的
voluptuous - 奢侈逸乐的，沉溺酒色的
voracious - 有很大含量的，贪吃的；贪婪的，如饥似渴的
votary - 崇拜者，信徒
vouch - 担保，声称为真
vulgar - 粗俗的，无教养的
vulnerable - 易受攻击的，脆弱的
waddle - 摇摇摆摆地走
waffle - 胡扯
waft - 飘荡，漂浮
wag - 摆动
wan - 苍白的，病态的
warble - 柔和地唱歌
wane - 减少，衰退，缺少的
wanting - 未出现的，缺少的；未达到要求的
warmonger - 好战者
warp - 曲解
warrant - 批准，认可
wary - 小心的，机警的，谨慎的
wastrel - 肆意挥霍的人，败家子
watershed - 重要关头，分水岭
wax - 增大，增强
waylay - 埋伏，伏击
welter - 混乱，动乱
wheedle - (用花言巧语)诱惑，哄骗
whet - 刺激，激起
winnow - 筛选
whimsical - 反复无常的
wholesome - 有益身心健康的
wicked - 邪恶的
wince - 畏缩
windbag - 健谈的人
windy - 冗长的
winsome - 迷人的，漂亮的
wit - 机智，智慧；智者，有智慧的人
withdraw - 撤退
wither - 枯萎，凋谢
withhold - 抑制；扣压，不给予
wizen - (使)凋谢，(使)枯萎；凋谢的，枯萎的
wobble - 摇晃，颤抖；犹豫不决
worldly - 世间的，世俗的；老练的
windfall - 好运，幸事
wrangle - 纷争，争端；争吵
wretched - 极差的；沮丧的
wry - 坚持错误的
xenophobe - 仇视(或畏惧)外国人(或外国事物)者
