yoke - 连接
yokel - 乡下人，天真纯朴的人
zeal - 热心，热诚
zealot - 狂热者，极端主义者
zenith - 最高点，巅峰
zesty - 刺激的，开胃的
abreast - 熟知的
appurtenance - 附属物
acclaim - 称赞；赞扬，赞颂
apostle - (政策或思想等的)信奉者，支持者
accord - 一致；相符合，相一致；授予，给予
accustom - 使习惯
acquire - 获取，获得
acquisitive - 贪婪的
adjudicate - 裁决，判定
adversity - 厄运，逆境
affectation - 虚伪，做作
affirm - 声称…为真，肯定…属实
affix - 粘合
affliction - 痛苦，悲伤，折磨
agape - 急切盼望的
agility - (身手)敏捷
agonize - (使)非常痛苦
agreeable - 令人愉悦的；相一致的
alienate - 使…疏远
alloy - 合金；混合物；掺杂，降低…的纯度
ambivalent - (尤指感情、态度)矛盾的
anachronism - 不合时代的人或事物；过时现象；时代错误，年代误植(指所叙人、事与时代不符的错误)
analogous - 相似的，可比较的
annex - 添加，合并
annotate - 给…作注解
antedate - 比…早，早于
antipathy - 厌恶，反感
antiquated - 古老的，过时的
antithetical - 完全对立的，相反的
apparition - 鬼魂，幽灵
applicable - 可用的，可行的；相关的，有关的
apprehensive - 知晓的，理解的；恐惧的，害怕的
arable - 适合耕种的
arbitrary - 专横的，独断专行的；缺乏计划的，随意的
arcane - 深奥的，难以理解的
argument - 争吵，争论；(逻辑上的)论证
arid - 干燥的；无趣的，无聊的
array - 排列，阵列；排列，摆放
assail - 抨击，严厉批评
atrophy - 萎缩，衰退
attest - 证实，为…作证
attune - 使协调，使和谐
august - 威严的，庄重的
auspicious - 好兆头的
