austere - 朴素的，朴实无华的
automatic - 自发的，情不自禁的
avowal - 承认，公开宣布
backfire - 产生相反的结果，事与愿违
backslide - (情况等)倒退，变坏
baffle - 使疑惑
bohemian - 特立独行之人
bash - 抨击，严厉批评
beholden - 欠他人人情的
behoove - 对…有利
beige - 缺乏特征的
bureaucratic - 官僚主义的
belligerent - 好斗的，好战的
beset - 使苦恼，骚扰；攻击，袭击
bewitching - 迷人的，令人着迷的
blackmail - 敲诈，勒索
bluff - 直率的，(说话)直截了当的；欺骗
bogus - 伪造的，假冒的
bore - 令人厌烦的人或事物；使厌倦，使厌烦
brandish - (带有威胁性地)挥舞
brim - 边缘，边界；充满
bumble - 含糊不清地说，杂乱无章地说
bustle - 忙乱，喧闹；(快速地)行走，奔忙
calamity - 大灾难
calculated - 经过计算(成败得失)的，经过深思熟虑的
canny - 精明的，聪明的
canonize - 使崇高，使神圣
captious - 吹毛求疵的，爱挑毛病的
careen - 蹒跚而行，不稳地行走
carefree - 无忧无虑的
cascade - 一连串，大量
cellular - 多孔的
ceremonious - 讲究礼节的，庄重的
certitude - 确信无疑
channel - 将…导向，投入
chaperone - 同行，护送
charisma - 魅力，吸引力
cherished - 受喜爱的，珍爱的
chivalrous - 有骑士风度的，(尤指对女性)彬彬有礼的
chorale - 赞美诗；合唱班，合唱团
clamor - 喧闹，喧哗，噪声
clan - (有共同爱好的)团体，帮派
cleave - 紧贴，坚持；分隔，割裂，劈开
cling - 紧贴；支持
coarse - 粗糙的，表面不平整的；粗俗的
cohesive - 有粘性的；有凝聚力的
commiserate - 表示怜悯，同情
compatible - 一致的，能共存的
compelling - 极具说服力的
complacent - 自满的，自鸣得意的
