complementary - 互补的
complicate - 使复杂化
comprehend - 理解，了解；包括，包含
concrete - 事实性的，明确的
condemn - 谴责(…为不道德的、邪恶的)
conditional - 有条件的，受制约的
conflagration - 武装冲突，战争
conflate - 混合
conform - 使协调；遵照，遵从
conjure - 请求，恳求；在脑海中浮现，想起
consent - 同意，赞同；同意
consign - 转交，转移(给他人)
consternation - 惊愕，恐慌，恐惧
contemplate - 沉思，仔细思索
contempt - 蔑视，鄙视
contend - 竞争，争夺；声明，声称
contradict - 否认，反驳；与…相矛盾
contrived - 不自然的，刻意的
convene - 召开，召集
correlate - 使…相关联
counterpart - (地位、功能)对等的人或物
counterproductive - 反效果的，阻碍预期目标的
courteous - 礼貌的，谦恭有礼的
coy - 不愿与人交往的，内向的
credit - 信任，信赖；表扬，赞扬
crow - 感到高兴
damn - (在道德上)谴责
dampen - 抑制，压抑(感情、精力等)，泼冷水
dashing - 爱好冒险的，大胆的
dated - 过时的
deadlock - 僵局；使陷入僵局，使停顿
debonair - 无忧无虑的，不在乎的；风度翩翩的
decadent - 堕落的，腐败的；道德上堕落的人
decry - 强烈反对，否定
deflect - 使偏斜，使转向
defray - 支付
deign - (不情愿地)屈尊，俯就
delegate - 代理人，代表；移交(权力、任务等)
delineate - 描写，描绘
demote - 降职，降级
dependable - 可靠的，值得信赖的
deplorable - 可鄙的，可耻的
dichotomy - 对立
dictate - (仗着地位、权力)下令
discreet - (言行)谨慎的
disenchant - 使清醒
dishearten - 使沮丧，使失去信心
disjunctive - 分离的
disprove - 反驳，证明为假
distinctive - 完全不同的；特征性的，典型的
