doctrinaire - 教条主义的，照本宣科的
domineer - 专制统治
drab - 单调的，无聊的
dramatic - 显著的，惹人注意的
dread - 恐惧
duplicate - 复制品；复制
eclectic - 混合的，多元化的
efficacious - 有效的
elude - 躲闪，躲避；使无法理解，使困惑
enamored - 迷恋的，热爱的
endeavor - 努力，奋斗；努力做，拼搏
enthrall - (像用魔咒般)吸引
equilibrium - 均势，平衡
escort - 同行，护送
ethos - 道德准则
exorcise - 除去
explicate - 解释，说明
exterminate - 根除，消灭
extrapolate - (通过逻辑)推断
fabulous - 幻想中的，不真实的；极好的
fad - (短暂的)流行，时尚
fallible - 可能出错的
fanciful - 不切实际的，荒谬的
favoritism - 偏爱，偏袒
featureless - 缺乏特征的
feisty - 好斗的，好争论的
felony - 重罪
ferocious - 激烈的，爆发性的；凶猛的，残暴的
fervent - 充满感情的，热情洋溢的
figment - 虚构的事物，幻觉
fitful - 断断续续的
fleeting - 稍纵即逝的，短暂的
forage - 寻找
forebode - 预示，预兆
foreground - 强调，重视
forfeit - 罚金
forsake - 彻底放弃，抛弃
frosty - 寒冷的；无强烈感情的，冷淡的
gawky - (举止)笨拙的
germinate - 发芽；出现
glacial - 极冷的；冷漠的，无感情的
glide - 轻松地行动，轻松地通过
glower - 怒目而视
graft - 移植，移接
grit - (面对困难时所表现出来的)毅力
groggy - 虚弱的，(走路)不稳的
grudge - 怨恨，仇恨
grumble - (尤指低声地)抱怨，埋怨
halfhearted - 不感兴趣的，不热情的
heckle - 起哄，使难堪
