hierarchical - 分等级的，等级制的
hobble - 阻碍，妨碍
humdrum - 无聊的，乏味的
humiliate - 羞辱，使丧失尊严
hypothetical - 假设，前提条件；假定的
idiosyncrasy - 独特而奇怪的习惯
idle - 闲置的，未使用的；懒散的；懒散度日，无所事事
ill-bred - 没有教养的，没有礼貌的
illustrious - 著名的，杰出的
imperishable - 不朽的，永恒的
implicit - 不言而喻的，心照不宣的
impunity - 免责，免受处罚
incentive - 刺激，诱因
incumbent - 义不容辞的，必须的
indecorous - 不合乎礼节的，不得体的
infraction - 违背，违犯
justify - 证明…的合理性，为…辩解
lag - 缓慢行走；萎靡，失去活力
lance - 刺穿，刺破
lax - 松弛的，不紧的，不严格的；懈怠的，漫不经心的
license - 许可，认可；自由
lionize - 追捧，把…捧为名人
ludicrous - 荒唐的，可笑的
luminous - 杰出的，重要的
lurid - 恐怖的，令人反感的
machination - 诡计
madcap - 热爱冒险的人；大胆的，鲁莽的
magnitude - 重要，重大
malevolent - 恶意的，恶毒的
malignant - 恶毒的，邪恶的
maneuver - 巧妙地操纵
marginal - 不重要的
meditate - 思索，沉思
menial - 卑贱的，低下的
meretricious - 艳俗的，俗气的
milieu - 环境，氛围
misapprehension - 错误的理解、判断
monarch - 君主，帝王
monopolize - 垄断，主宰
nirvana - 天堂
nostalgia - 怀旧，怀念
notoriety - 坏名声
nourish - 培养，促进
novice - 新手，初学者
nullification - (尤指法律条文等正式的)废除，废弃
numb - 麻木的，无感情的
oaf - 愚蠢的人
observant - 警惕的，警觉的；严格遵守(规章、制度或原则)的
obsolete - 过时的，被淘汰的
onset - 起始，开始
