ordeal - 严峻的考验
ostensible - 表面上的，佯装的
outgrowth - 结果，后果
outmoded - 过时的，废弃的
override - 推翻
overshadow - (在重要性上)超越，超过
overwhelm - 淹没
overwrought - 十分激动的，非常不安的；(装饰、文风等)过分华丽的
palaver - 对话，交流；闲聊
palpitation - (有节奏的)舒张收缩
panacea - 万能药，万灵药
peculiarity - 特征，特点
pedagogical - 教学的；教师的
peel - 脱去(衣服等)
perceptive - 敏锐的
perilous - 危险的
perquisite - 额外的好处
petulant - 易怒的，爱发脾气的
pioneer - 扩荒者，先驱者；开创，创造
pious - (信仰上)虔诚的
pitfall - 陷阱
pivotal - 最关键的，最为重要的
placid - 冷静的，淡定的
playful - 爱开玩笑的
plebeian - 平民的，社会下层的
plush - 奢华的，豪华的
poach - 水煮
pointer - 忠告，建议
pragmatic - 实用主义的，务实的
premeditate - 预先考虑
prerequisite - 前提，先决条件
prerogative - 特权，权力
proclaim - 宣告，使…公之于众
project - 预测，预计
proprietary - 私营的
prototype - 原型
rampant - (植物)生长茂盛的；猖獗的，不受限制的
ravenous - 食量大的，贪食的；贪婪的
redeem - 改过自新
refreshing - 令人身心振奋的，提神的
remnant - 残余，剩余物
renege - 放弃，摒弃
replenish - 补充
replicate - 复制，复刻
residual - 剩余的，残存的
restitution - 补偿，赔偿
resurrect - 使重生，使复苏
retentive - 记性好的
retrieve - 寻回，找回
reverberate - 回荡，回响
