bravado - 假装勇敢；虚张声势
bravura - 优秀演技(的)
brazen - 蛮横大胆的，厚颜无耻的；大胆自信地去面对或从事
breach - 违背
brevity - 简短，简洁
bribe - 贿赂，收买
bridle - 限制
brisk - 充满生机的，有活力的
bristle - 怒不可遏，咆哮
brittle - 易碎的，脆弱的，易坏的；不热心的，不真心的
broach - 提出讨论
bromide - 陈词滥调
brook - 忍受，容许
browbeat - 恐吓
bruit - (未经证实地)散播(消息)
buck - 阻止，反对
budge - 停止抵抗，屈服
bulge - 凸起
bully - 欺凌弱小者
bumptious - 专横傲慢的，自以为是的
bungle - 办糟，失败
buoy - 使充满勇气和力量，使振作
buoyant - 心情好的
burgeon - 迅速成长扩大，蓬勃发展
burlesque - 夸张滑稽地模仿以嘲弄他人的文学艺术作品，恶搞
burnish - 擦亮，磨光
buttress - 为…提供支撑的证据或者信息
byzantine - 错综复杂的
cache - 囤货，藏货
cachet - 同意；声望
cacophony - 刺耳的声音
cavalier - 彬彬有礼的绅士；傲慢的
cajole - 哄骗
calcify - 使僵化
calibrate - 校准，调校
calligraphy - (优美的)书法
callous - 无同情心的，冷漠的
callow - 不老练的，不成熟的
calumniate - 诽谤，造谣，中伤
camaraderie - 友情
catharsis - 情绪的宣泄、释放
camouflage - 伪装；伪装手段
canard - 谣传，误传
candor - 坦白，直率，诚挚
canon - 准则，标准；真经，正典
canvass - 仔细检查，详尽讨论；游说，去(一个地区)的各处或找到(个人)来拉选票或订单
capitulate - 投降，默许
caprice - 反复无常，善变
captivate - 吸引
careworn - 忧心忡忡的，焦虑的
cardinal - 主要的，非常重要的
