rhetorical - 言辞华丽(却往往无内涵)的
rigmarole - 混乱无意义的话
ruthless - 没有怜悯心的，残忍的
screen - 掩护物，屏障；掩护，遮蔽
scrimp - 节俭
sectarianism - 宗派主义，顽固
secular - 世俗的，尘世的
simile - 明喻
skittish - 容易受到惊吓的，胆小的；善变的，多变的
sparing - 节俭的，节约的
splutter - 急切而不清楚地说
squeamish - 恶心的，晕船的
staunch - 忠诚的，坚定的
stereotype - 成见，老套的理念
stigmatize - 使蒙上污名
substitute - 取代者，替代品；取代，替代
succumb - 屈服；死亡
supersede - 取代，替代
surly - 脾气不好的
surmise - (根据不足的)推测，揣测；推测
surmount - 战胜，获得胜利
surpass - 超越，强于
surrogate - 替代品
surveillance - 监视，监控
tame - 被驯化的；控制，抑制
tangle - 纠缠，使…纠结
teeming - 大量的
temporal - 世俗的，尘世的
tentative - 暂时性的，尝试的
thick-skinned - 冷漠无情的，不顾及他人感受的
thrill - 强烈的兴奋感，快感；使兴奋，使激动
timely - 恰到好处的，合乎时宜的
trifling - 细微的，不重要的
tycoon - 大亨，巨头
tyrant - 暴君
umbrage - 不悦，生气
unanimous - 一致同意的
unavailing - 徒劳的，无果的
unremitting - 连续不断的
vouchsafe - 允诺，给予
wayward - 刚愎自用的，不服管束的
weather - 经受住
willful - 固执的，倔强的
willy-nilly - 无秩序的，随意的
wilt - 精神萎靡，憔悴
wily - 狡诈的，狡猾的
wiretap - 偷听，窃听
wistful - 渴望的，怀念的
wrest - 辛苦地获得
wrongheaded - 固执己见的，坚持(错误观点的)