caricature - 用讽刺歪曲等手法的夸张，漫画，讽刺画；嘲笑性模仿或夸张
carnal - 肉体的，物质的；世俗的
carouse - 畅饮，狂饮作乐
carp - 对小事吹毛求疵，挑剔，表现不满
cliquish - 小集团的
cast - 提出；抛弃
castigate - 强烈(公开)指责
catalyze - 成为…的导火索，导致
catastrophe - 大灾难；彻底的失败
categorical - 没有例外的；绝对的
catholic - 普遍的，包容的
caustic - 挖苦讽刺的，刻薄的
caveat - 警告，告诫
cavil - 挑剔，吹毛求疵
cataclysmal - 灾难性的
cede - (根据条约)放弃，割让
cement - 粘合，粘合剂
censor - 审查并删除不良的东西
concomitant - 伴随的，同时发生的
censure - 公开表示反对，谴责
chic - 时髦的，潮的
cessation - 终止，暂停
chaff - 开玩笑
chagrin - (因为失败、出糗而导致的)不安，焦虑
chameleon - 变色龙，善变的人
champion - 支持
compulsive - 不能自拔的
chimera - 虚构的事物，幻觉
charlatan - 骗子，装懂的人
chary - 非常谨慎的
chase - 驱赶
chasm - 分歧，(意见、利益或忠诚上的)明显差异
chauvinistic - 盲目爱国的
check - 使突然停止，阻止；同意，一致
cherubic - 天使般可爱的
chicanery - n．诡计多端，欺骗
chide - 责备
choleric - 易怒的，暴躁的
chord - 与…和谐一致；符合
chromatic - 彩色的
chronic - 经常发生的，复发的
churlish - 粗鲁无礼的
cipher - 密码
circuitous - 迂回的，不直接的
circumlocution - 冗长
circumscribe - 限制
circumspect - 谨慎的，小心的
circumvent - 躲避，不遵从
civility - 彬彬有礼
chokehold - 压制
clandestine - 隐藏的，秘密的
