clarion - 清楚响亮的
clarity - 清晰，清楚
clasp - 紧握
clement - 宽容的，善良的；气候温和的
cliché - 陈词滥调(的)
clog - 阻碍物；阻碍
clot - 密集的一群；凝结
cordial - 热情的，友好的；令人振奋的，令人焕然一新的
clout - 权力，影响力
cloying - 甜得发腻的；感情用事的
clumsy - 笨拙的
coagulate - (使)凝结，(使)变稠
coalesce - 合并，融合
coax - 哄骗
coda - 终曲
coerce - (以武力)强制
coeval - 同时代的，同龄的
cogent - 令人信服的；相关的
cognizant - 知道的，意识到的
collapse - 失败
collude - 串通，共谋(做坏事)
colossal - 巨大的
coltish - 爱开玩笑的
coma - 昏迷，深度无知觉
combustible - 可燃的；容易激动的
cluster - 一群人
comity - 友好，社会和谐
commencement - 开始；毕业典礼
commend - 赞扬
commensurate - 同样大小的；相称的，相当的
commingle - 充分混合
commitment - 致力，投入；承诺，表态
committed - 忠诚的，忠实的
commodious - 宽敞舒适的
commonsensical - 符合常识的，有依据的
commotion - 骚乱
compendium - 摘要
complacency - 自满，无忧患意识
complaisance - 愿意顺从，讨好，彬彬有礼
compliant - 顺从的
compliment - 称赞，恭维；敬意，免费赠送的礼物
clownish - 滑稽可笑的
compose - 组成，构成；使镇定
compound - 混和物；混合的；混合；使恶化，加重
compress - 压缩(体积)
compromise - 妥协；使危险
compunction - 焦虑，内疚，良心不安
concatenate - 连结，混合
concoct - 捏造，编造
conceal - 隐藏，隐瞒
concede - 承认
