concentrate - 聚集；浓缩
concerted - 共同完成的
conciliate - 平息，抚慰
commonplace - 司空见惯的(事物)
concord - 一致，和睦
concur - 同意；同一时间发生、存在；团结合作
condescending - 摆出高人一等的姿态的
condign - 应得的，恰当的
condole - 表达同情
condone - 宽恕；忽视
conducive - 有益的，有促进作用的
cantankerous - 脾气不好的
confine - 限制
confluence - 汇合，混合
confront - 直接对抗，直面
confound - 使困惑；证明为假，证伪
congeal - 凝固，固化
congenial - 和善的，友好的
congruent - 和谐一致的；全等的
conjecture - 推测，猜测；(没有依据地)认为
connive - 暗中合作，共谋
connoisseur - 专家；鉴赏家(尤指艺术领域)
conscientious - 有良心的，正直的；仔细的，一丝不苟的
consensus - 一致同意
consequence - 结果；重要性，价值
conservative - 守旧的，不愿改变的；不招摇的，低调的
conservatory - 温室；艺术学院
consilience - 融合
considerable - (数量上)可观(而值得注意)的；值得考虑的，重要的
console - 安慰，藉慰
consolidate - 加固，使安全
consonant - 和谐一致的
conspicuous - 显而易见的，吸引人的
conspire - 合谋，密谋
constitute - 指派，任命；构成
constrain - 限制
constringe - 使紧缩
construct - 建造，建立；创造，想出
consummate - 专业的，有造诣的；无纰漏的，完美的
contagious - 传染的；(情绪等)唤起共鸣的
contaminate - 污染，感染
content - 使满足；内容，内涵
contentious - 引起争论的；好争论的，好战的
contiguous - 接壤的，相邻的
contort - 扭曲
contract - 契约，合同；收缩；感染疾病
contravene - 违反，反对
contrite - (因为有罪孽或过错而感到)后悔悲痛的
contumacious - 不服从的，倔强的
conundrum - 无法解决的问题，迷
convalesce - 渐渐康复，渐愈
